Unsafe
An Interactive Fiction by Brian Chen and Jakob Weisblat
Release 1 / Serial number 190223 / Inform 7 build 6M62 (I6/v6.33 lib 6/12N) SD

Bedroom
It's your bedroom. It's not very interesting. The hall is to the east. The side door (closed) leads out of the house to the West. You're lying in your bed, just having woken up.

On the nightstand is an iPod.

I beg your pardon?

* * *

Unsafe
An Interactive Fiction by Brian Chen and Jakob Weisblat
Release 1 / Serial number 190223 / Inform 7 build 6M62 (I6/v6.33 lib 6/12N) SD

Bedroom
It's your bedroom. It's not very interesting. The hall is to the east. The side door (closed) leads out of the house to the West. You're lying in your bed, just having woken up.

On the nightstand is an iPod.

>e
Hall
The hall in the middle of your house. Your bedroom is to the West. The staircase leading upwards is to the North. The back entryway is to the South. The kitchen is to the East. There is a muddy brown key hanging from a hook on the wall. You can also go down to the basement from here.

You can see a Staircase and a muddy brown key here.

* * *

>e
Kitchen
You can see a toaster, a cabinet (closed), a refrigerator (closed) and a stool here.

>e
You can't go that way.

* * *

>open fridge
You open the refrigerator, revealing a fish and a pie.

>take pie
Taken.

>take fish and stool
fish: One thing at a time!
stool: One thing at a time!

* * *

>w
Hall
The hall in the middle of your house. Your bedroom is to the West. The staircase leading upwards is to the North. The back entryway is to the South. The kitchen is to the East. There is a muddy brown key hanging from a hook on the wall. You can also go down to the basement from here.

You can see a Staircase and a muddy brown key here.

>d
Basement
The dark basement of your house. The hall is upstairs. The Tunnel of Extraction is to the west.

You can see The Tunnel of Extraction here.

>go through tunnel
Abandoned Warehouse
The warehouse is old and abandoned.It is big and extends south. Not much more to say. The Road is to the North. The Tunnel of Extraction is below. There are holes in the wall to the East and West.

You can see The Tunnel of Extraction here.

>e
Town Square
You can see the Mad Scientist's Grand Entrance here.

>open entrance
You open the Mad Scientist's Grand Entrance.

>s
Mad Scientist's house
A house filled with so many useless gadgets the like of which you've never seen. There are tubes, filling two thirds of the room. High up on the wall there is a shelf. Taking up one entire wall of the room is an enormous amplifier.

On the tool shelf are a small tool box (closed) and a bottle of soylent.

You can also see the Mad Scientist's Grand Entrance and a ladder here.

>put down shelf
The tool shelf is already here.

>undo
Mad Scientist's house
[Previous turn undone.]

>put down stool
Dropped.

* * *

>get on stool
You get onto the stool.

>get glue
Taken.

>eat flue
You can't see any such thing.

>eat glue
That doesn't look very edible right now. Maybe if you could actually squeeze it into your mouth?

>undo
Mad Scientist's house
[Previous turn undone.]

* * *

>get on stool
You get onto the stool.

>x shelf
A high-up shelf that you imagine stores the mad scientist's secrets.  On the tool shelf, you can see a small tool box and a bottle of soylent. That's disappointing.

On the tool shelf are a small tool box (closed) and a bottle of soylent.

>get box
Taken.

>open box
You open the small tool box, revealing Super glue.

>get glue
Taken.

>eat glue
That doesn't look very edible right now. Maybe if you could actually squeeze it into your mouth?

>n
(first getting off the stool)

Town Square
You can see the Mad Scientist's Grand Entrance here.

>w
Abandoned Warehouse
The warehouse is old and abandoned.It is big and extends south. Not much more to say. The Road is to the North. The Tunnel of Extraction is below. There are holes in the wall to the East and West.

You can see The Tunnel of Extraction here.

>s
A Spooky Lair
A lair in which a demonic ritual might be held. There is a table with a pentagram drawn on it.

On the table are a candle and a sacrificial knife.

You can also see four snakes here.

>get knife
Taken.

>cut glue
You use the sacrificial knife to cut the super glue's tip right off. Glue gurgles out of the tube viscously.

>eat glue
You squeeze the tube of super glue into your mouth. It tastes like candy! Shortly thereafter, it starts to taste like your throat is glued shut. Maybe this wasn't a great idea...
You've reached one of this game's 14 endings! In that game you used 22 moves. The optimal number of moves is 19.
You can reach this ending more quickly!

    *** You have died ***

Would you like to RESTART, RESTORE a saved game, QUIT or UNDO the last command?

>restart
You wake up in your bedroom.

Unsafe
An Interactive Fiction by Brian Chen and Jakob Weisblat
Release 1 / Serial number 190221 / Inform 7 build 6M62 (I6/v6.33 lib 6/12N) SD

Bedroom
It's your bedroom. It's not very interesting. The hall is to the east.

You can see the Side Door here.

>test glue
(Testing.)

>[1] e

Hall
The hall in the middle of your house. Your bedroom is to the West. The staircase leading upwards is to the North. The back entryway is to the South. (??) The kitchen is to the East.

You can see a Staircase here.

>[2] e

Kitchen
You can see a toaster, a cabinet (closed), a refrigerator (closed) and a stool here.

>[3] take stool
Taken.

>[4] w

Hall
The hall in the middle of your house. Your bedroom is to the West. The staircase leading upwards is to the North. The back entryway is to the South. (??) The kitchen is to the East.

You can see a Staircase here.

>[5] down

Basement
The dark basement of your house. The hall is upstairs. The Tunnel of Extraction is to the west.

You can see The Tunnel of Extraction here.

>[6] go through tunnel

Abandoned Warehouse
The warehouse is old and abandoned.It is big and extends south. Not much more to say. The Road is to the North. The Tunnel of Extraction is below. There are holes in the wall to the East and West.

You can see The Tunnel of Extraction here.

>[7] s

A Spooky Lair
A lair in which a demonic ritual might be held. There is a table with a pentagram drawn on it.

On the table are a candle and a sacrificial knife.

You can also see four snakes here.

>[8] get knife
Taken.

>[9] n

Abandoned Warehouse
The warehouse is old and abandoned.It is big and extends south. Not much more to say. The Road is to the North. The Tunnel of Extraction is below. There are holes in the wall to the East and West.

You can see The Tunnel of Extraction here.

>[10] e

Town Square
You can see the Mad Scientist's Grand Entrance here.

>[11] open entrance
You open the Mad Scientist's Grand Entrance.

>[12] s

Mad Scientist's house
A house filled with so many useless gadgets the like of which you've never seen. There are tubes, filling two thirds of the room. High up on the wall there is a shelf. Taking up one entire wall of the room is an enormous amplifier.

On the tool shelf are a small tool box (closed) and a bottle of soylent.

You can also see the Mad Scientist's Grand Entrance and a ladder here.

>[13] put down stool
Dropped.

>[14] get on stool
You get onto the stool.

>[15] get box
Taken.

>[16] open box
You open the small tool box, revealing Super glue.

>[17] get glue
Taken.

>[18] cut glue
You use the sacrificial knife to cut the super glue's tip right off. Glue gurgles out of the tube viscously.

>[19] eat glue
You squeeze the tube of super glue into your mouth. It tastes like candy! Shortly thereafter, it starts to taste like your throat is glued shut. Maybe this wasn't a great idea...
You've reached one of this game's 14 endings! In that game you used 19 moves. The optimal number of moves is 19.
Great job, you got the optimal number of moves!

    *** You have died ***

Would you like to RESTART, RESTORE a saved game, QUIT or UNDO the last command?

* * *

>d
Basement
The dark basement of your house. The hall is upstairs. The Tunnel of Extraction is to the west.

You can see The Tunnel of Extraction here.

>w
Abandoned Warehouse
The warehouse is old and abandoned.It is big and extends south. Not much more to say. The Road is to the North. The Tunnel of Extraction is below. There are holes in the wall to the East and West.

You can see The Tunnel of Extraction here.

>e
Town Square
You can see the Mad Scientist's Grand Entrance here.

>s
You can't go through the Mad Scientist's Grand Entrance because it's closed.

* * *

>open entrance
You open the Mad Scientist's Grand Entrance.

>s
Mad Scientist's house
A house filled with so many useless gadgets the like of which you've never seen. There are tubes, .

You can see the Mad Scientist's Grand Entrance and a ladder here.

>go up ladder
I only understood you as far as wanting to go up.

>use ladder
That's not a verb I recognise.

>go through ladder
Mad Science Laboratory
You can see a ladder and a time machine here.

>d
Mad Scientist's house
A house filled with so many useless gadgets the like of which you've never seen. There are tubes, .

You can see a ladder and the Mad Scientist's Grand Entrance here.

* * *

>w
Hall
The hall in the middle of your house. Your bedroom is to the West. The staircase leading upwards is to the North. The back entryway is to the South. The kitchen is to the East. There is a muddy brown key hanging from a hook on the wall. You can also go down to the basement from here.

You can see a Staircase and a muddy brown key here.

>w
Bedroom
It's your bedroom. It's not very interesting. The hall is to the east. The side door leads out into the Garden to the West.

You can see the Side Door here.

>open door
You open the Side Door.

>w
The Garden
You can see the Side Door and the Shed (closed) here.

>put down stool
Dropped.

>get bucket
You can't reach the roof of the shed.

>get on stool
You get onto the stool.

* * *

>e
Kitchen
You can see a toaster, a cabinet (closed), a refrigerator (closed) and a stool here.

>open fridge
You open the refrigerator, revealing a fish and a pie.

>take stool and fish
stool: Taken.
fish: Taken.

>undo
Kitchen
[Previous turn undone.]

>undo
Kitchen
[Previous turn undone.]

>open fridge
You open the refrigerator, revealing a fish and a pie.

* * *

>e
Hall
The hall in the middle of your house. Your bedroom is to the West. The staircase leading upwards is to the North. The back entryway is to the South. The kitchen is to the East. There is a muddy brown key hanging from a hook on the wall. You can also go down to the basement from here.

You can see a Staircase and a muddy brown key here.

>get key
Taken.

>w
Bedroom
It's your bedroom. It's not very interesting. The hall is to the east.

You can see the Side Door here.

>open door
You open the Side Door.

* * *

>w
The Garden
You can see the Side Door and the Shed (closed) here.

>unlock shed
(the Shed with the muddy brown key)
You unlock the Shed.

>open shed
(the Shed)
You open the Shed, revealing a cage.

>get cage
Taken.

>x shed
(the Shed)
A narrow rusty shed. The shed is really tall and you can't see above it.

>x cage
A white metal cage that looks to have held a pet rabbit long ago.

>undo
The Garden
[Previous turn undone.]

>undo
The Garden
[Previous turn undone.]

>l cage
A white metal cage that looks to have held a pet rabbit long ago.

>undo
The Garden
[Previous turn undone.]

>i
You are carrying:
  a muddy brown key

>undo
The Garden
[Previous turn undone.]

>get cage
Taken.

>e
Bedroom
It's your bedroom. It's not very interesting. The hall is to the east.

You can see the Side Door here.

>e
Hall
The hall in the middle of your house. Your bedroom is to the West. The staircase leading upwards is to the North. The back entryway is to the South. (??) The kitchen is to the East.

You can see a Staircase here.

>d
Basement
The dark basement of your house. The hall is upstairs. The Tunnel of Extraction is to the west.

You can see The Tunnel of Extraction here.

>w
Abandoned Warehouse
The warehouse is old and abandoned. It is big and extends south. Not much more to say. The Road is to the North. The Tunnel of Extraction is below. There are holes in the wall to the East and West.

You can see The Tunnel of Extraction here.

>s
A Spooky Lair
A lair in which a demonic ritual might be held. There is a table with a pentagram drawn on it.

On the table are a candle and a sacrificial knife.

You can also see four snakes and an ancient cabinet (closed) here.

>put down cage
Dropped.

>open cabinet
You open the ancient cabinet, revealing three jars.

>x cabinet
The ancient cabinet seems like it could have been here for millenia.

In the ancient cabinet are three jars.

>open cabinet
That's already open.

>get jar
Taken.

>get jars
jar: Taken.
jar: Taken.

>i
You are carrying:
  a jar (open)
    a mouse
  a jar (open)
    a mouse
  a jar (open)
    a mouse
  a muddy brown key

>open jars
You can't use multiple objects with that verb.

>open jar
That's already open.

>i
You are carrying:
  a jar (open)
    a mouse
  a jar (open)
    a mouse
  a jar (open)
    a mouse
  a muddy brown key

>get mouse
I don't suppose the mouse would care for that.

>put mouse in cage
(first taking the mouse)
I don't suppose the mouse would care for that.

>put jar in cage
You put the jar into the cage.

>grab snake
That's not a verb I recognise.

>get snake
I don't suppose the snake would care for that.

* * *

>open shed
(the Shed)
You open the Shed, revealing a cage.

>x shed
(the Shed)
A narrow rusty shed. The shed is really tall and you can't see above it.

* * *

>e
Hall
The hall in the middle of your house. Your bedroom is to the West. The staircase leading upwards is to the North. The back entryway is to the South. The kitchen is to the East. There is a muddy brown key hanging from a hook on the wall. You can also go down to the basement from here.

You can see a Staircase and a muddy brown key here.

>l
Hall
The hall in the middle of your house. Your bedroom is to the West. The staircase leading upwards is to the North. The back entryway is to the South. The kitchen is to the East. There is a muddy brown key hanging from a hook on the wall. You can also go down to the basement from here.

You can see a Staircase and a muddy brown key here.

>e
Kitchen
You can see a toaster, a cabinet (closed), a refrigerator (closed) and a stool here.

>take stool
One thing at a time!

* * *

>e
Hall
The hall in the middle of your house. Your bedroom is to the West. The staircase leading upwards is to the North. The back entryway is to the South. The kitchen is to the East. There is a muddy brown key hanging from a hook on the wall. You can also go down to the basement from here.

You can see a Staircase and a muddy brown key here.

>n
Upstairs Hall
The second floor of your house. Stairs lead down. The study is west, and the bathroom is east.

You can see a Staircase here.

>w
Study
Where you study. The hall is east.

You can see the closet door here.

>x closet door
You see nothing special about the closet door.

>go through closet door
The Closet
A small room. The hall is south.

You can see the closet door here.

>s
Study
Where you study. The hall is east.

You can see the closet door here.

>i
You are carrying nothing.

* * *

>e
Hall
The hall in the middle of your house. Your bedroom is to the West. The staircase leading upwards is to the North. The back entryway is to the South. The kitchen is to the East. There is a muddy brown key hanging from a hook on the wall. You can also go down to the basement from here.

You can see a Staircase and a muddy brown key here.

>u
upstairs hall
The second floor of your house. Stairs lead down. The study is west, and the bathroom is east.

You can see a Staircase and a left running shoe here.

>w
Study
Where you study. The hall is east.

On the desk are a dime and a quarter.

You can also see the closet door here.

>get dime
Taken.

>get quarter
Taken.

>e
Upstairs Hall
The second floor of your house. Stairs lead down. The study is west, and the bathroom is east.

You can see a Staircase here.

>d
Hall
The hall in the middle of your house. Your bedroom is to the West. The staircase leading upwards is to the North. The back entryway is to the South. (??) The kitchen is to the East. There is a muddy brown key hanging from a hook on the wall.

You can see a Staircase and a muddy brown key here.

>d
Basement
The dark basement of your house. The hall is upstairs. The Tunnel of Extraction is to the west.

You can see The Tunnel of Extraction here.

* * *

>w
Abandoned Warehouse
The warehouse is old and abandoned. It is big and extends south. Not much more to say. The Road is to the North. The Tunnel of Extraction is below. There are holes in the wall to the East and West.

You can see The Tunnel of Extraction here.

>e
Town Square
You can see the Mad Scientist's Grand Entrance here.

* * *

>s
Mad Scientist's house
A house filled with so many useless gadgets the like of which you've never seen. There are tubes, filling two thirds of the room. High up on the wall there is a shelf. Taking up one entire wall of the room is an enormous amplifier.

On the tool shelf are a small tool box (closed) and a bottle of soylent.

You can also see the Mad Scientist's Grand Entrance and a ladder here.

>climb ladder
Mad Science Laboratory
You can see a ladder and a time machine (in which are a red button and a coin slot (closed)) here.

>enter time machine
You get into the time machine.

In the time machine you can see a red button and a coin slot (closed).

>put dime in slot
That doesn't fit in the slot!

>put quarter in slot
You put a quarter in the slot. It makes a satisfying *clink*.

>i
You are carrying:
  a dime

>press button
You feel yourself pressed back into the seat, and the world swirls around you. The sun sets and rises again 14 times. And then, suddenly, the world is calm.

>push button
You need to insert a quarter first.

>showme time machine
time machine - open container
    yourself - person
        dime
    red button
    coin slot - closed container
location: in the Mad Science Laboratory
singular-named, improper-named; unlit, inedible, fixed in place; enterable, opaque, open, unopenable, unlocked
list grouping key: none
printed name: "time machine"
printed plural name: "containers"
indefinite article: none
description: none
initial appearance: none
carrying capacity: 100
use count: 0

>showme coin slot
coin slot - closed container
location: in the time machine in the Mad Science Laboratory
singular-named, improper-named; unlit, inedible, fixed in place; opaque, closed, unopenable, unlocked
list grouping key: none
printed name: "coin slot"
printed plural name: "containers"
indefinite article: none
description: none
initial appearance: none
carrying capacity: 100
credits: 0

>d
You would have to get out of the time machine first.

>exit time machine
I only understood you as far as wanting to exit.

>get out of time machine
I only understood you as far as wanting to get outside.

>leave time machine
I only understood you as far as wanting to leave.

>get out of the time machine
I only understood you as far as wanting to get outside.

>get out
You get out of the time machine.

Mad Science Laboratory
You can see a ladder and a time machine (in which are a red button and a coin slot (closed)) here.

>d
Mad Scientist's house
A house filled with so many useless gadgets the like of which you've never seen. There are tubes, filling two thirds of the room. High up on the wall there is a shelf. Taking up one entire wall of the room is an enormous amplifier.

On the tool shelf are a small tool box (closed) and a bottle of soylent.

You can also see a ladder and the Mad Scientist's Grand Entrance here.

>n
Town Square
You can see the Mad Scientist's Grand Entrance here.

>w
Abandoned Warehouse
The warehouse is old and abandoned. It is big and extends south. Not much more to say. The Road is to the North. The Tunnel of Extraction is below. There are holes in the wall to the East and West.

You can see The Tunnel of Extraction here.

* * *

>w
Edge of the Woods
The woods start here and extend to the west. There's a clearing to the east.

>w
Woods
There's lots of trees. The edge of the woods is to the east. Going south, you can enter a hunting lodge.

>w
Too many trees. You'd get lost.

>s
Hunting Grounds
Where hunters hunt things, as long as it's the right season. The woods are to the north. You can head into the Hunting Lodge to the south.

>s
Hunting Lodge
Where hunters rest or something. One wall is covered in animal heads - a deer, a moose, a lion(!). Kinda creepy, to be honest. The exit is north.

You can see a moose head, a deer head and a lion head here.

>l
Hunting Lodge
Where hunters rest or something. One wall is covered in animal heads - a deer, a moose, a lion(!). Kinda creepy, to be honest. The exit is north.

You can see a moose head, a deer head and a lion head here.

>l
Hunting Lodge
Where hunters rest or something. One wall is covered in animal heads - a deer, a moose, a lion(!). Kinda creepy, to be honest. The exit is north.

You can see a moose head, a deer head and a lion head here.

>x bear
You can't see any such thing.

>x lion head
You see nothing special about the lion head.

>x moose head
You see nothing special about the moose head.

>get moose head
Taken.

>wear moose head
You put on the moose head.

>go out
You can't go that way.

>n
You go into the hunting groundsYou've reached one of this game's 14 endings! In that game you used 38 moves. The optimal number of moves is 100.
Uh-oh, the puzzle is broken! Send us an email!

    *** You have died ***

Would you like to RESTART, RESTORE a saved game, QUIT or UNDO the last command?

>s
Please give one of the answers above.

Would you like to RESTART, RESTORE a saved game, QUIT or UNDO the last command?

* * *

>get quarter
Taken.

>n
The Closet
A small room. The hall is south.

You can see the closet door and a chest of drawers here.

>get quarter
Taken.

>open second drawer
You open the second drawer, revealing a quarter.

>get quarter
Taken.

>s
Study
Where you study. The hall is east.

On the desk is a dime.

You can also see the closet door here.

>e
Upstairs Hall
The second floor of your house. Stairs lead down. The study is west, and the bathroom is east.

You can see a Staircase here.

>d
Hall
The hall in the middle of your house. Your bedroom is to the West. The staircase leading upwards is to the North. The back entryway is to the South. The kitchen is to the East. There is a muddy brown key hanging from a hook on the wall. You can also go down to the basement from here.

You can see a Staircase and a muddy brown key here.

>d
Basement
The dark basement of your house. The hall is upstairs. The Tunnel of Extraction is to the west.

You can see The Tunnel of Extraction and a vat (closed) here.

>w
Abandoned Warehouse
The warehouse is old and abandoned. It is big and extends south. Not much more to say. The Road is to the North. The Tunnel of Extraction is below. There are holes in the wall to the East and West.

You can see The Tunnel of Extraction here.

>e
Town Square
The Town Square stretches out in front of you. There are 10 or 20 unremarkable buildings that you couldn't care less about. South of you is the Mad Scientist's House. West, a hole in the wall leads into the Abandoned Warehouse. North of here, the town thins out.

You can see the Mad Scientist's Grand Entrance here.

* * *

>s
Mad Scientist's house
A house filled with so many useless gadgets the like of which you've never seen. There are tubes, filling two thirds of the room. High up on the wall there is a shelf. Taking up one entire wall of the room is an enormous amplifier.

On the tool shelf are a small tool box (closed) and a bottle of soylent.

You can also see the Mad Scientist's Grand Entrance and a ladder here.

>u
Mad Science Laboratory
You can see a ladder and a time machine (in which are a red button and a coin slot (closed)) here.

>enter time machine
You get into the time machine.

In the time machine you can see a red button and a coin slot (closed).

>put quarters in slot
quarter: You put a quarter in the slot. It makes a satisfying *clink*.
quarter: You put a quarter in the slot. It makes a satisfying *clink*.
quarter: You put a quarter in the slot. It makes a satisfying *clink*.

>undo
Mad Science Laboratory
[Previous turn undone.]

>put quarter in slot
You put a quarter in the slot. It makes a satisfying *clink*.

>put quarter in slot
You put a quarter in the slot. It makes a satisfying *clink*.

>press button
You feel yourself pressed back into the seat, and the world swirls around you. The sun sets and rises again 14 times. And then, suddenly, the world is calm.

>get out
You get out of the time machine.

Mad Science Laboratory
You can see a ladder and a time machine (in which are a red button and a coin slot (closed)) here.

* * *

>d
Mad Scientist's house
A house filled with so many useless gadgets the like of which you've never seen. There are tubes, filling two thirds of the room. High up on the wall there is a shelf. Taking up one entire wall of the room is an enormous amplifier.

On the tool shelf are a small tool box (closed) and a bottle of soylent.

You can also see a ladder and the Mad Scientist's Grand Entrance here.

>n
Town Square
The Town Square stretches out in front of you. There are 10 or 20 unremarkable buildings that you couldn't care less about. South of you is the Mad Scientist's House. West, a hole in the wall leads into the Abandoned Warehouse. North of here, the town thins out.

You can see the Mad Scientist's Grand Entrance here.

* * *

>w
Edge of the Woods
The woods start here and extend to the west. There's a clearing to the east.

>w
Woods
There's lots of trees. The edge of the woods is to the east. Going south, you can see signs for a hunting lodge.

>s
Hunting Grounds
Where hunters hunt things, as long as it's the right season. The woods are to the north. You can head into the Hunting Lodge to the south.

You can see the hunting lodge entrance here.

>open door
You can't see any such thing.

>go through door
You can't see any such thing.

>s
You can't go through the hunting lodge entrance because it's closed.

>s
You can't go through the hunting lodge entrance because it's closed.

>undo
Hunting Grounds
[Previous turn undone.]

>undo
Hunting Grounds
[Previous turn undone.]

* * *

>w
Study
Where you study. The hall is east.

On the desk are a dime and a quarter.

You can also see the closet door here.

>n
The Closet
A small room. The hall is south.

You can see the closet door and a chest of drawers here.

>open second drawer
You open the second drawer, revealing a quarter.

* * *

>get quarter
Taken.

>get quarter
Taken.

>put quarters in drawer
Which do you mean, the first drawer, the second drawer, the third drawer, the fourth drawer or the fifth drawer?

>put quarters in second drawer
quarter: Done.
quarter: Done.

>get quarters
quarter: Taken.
quarter: Taken.

>get quarter from fifth drawer
You can't see any such thing.

>get quarter
You already have that.

>i
You are carrying:
  two quarters

* * *

>open second drawer
You open the second drawer, revealing a quarter.

>get quarters
quarter: One thing at a time!
quarter: One thing at a time!

>get quarter
You're being greedy. Pick up one quarter at a time.

* * *

>w
Study
Where you study. The hall is east.

On the desk are a dime and a quarter.

You can also see the closet door here.

>restart
Are you sure you want to restart?

>y
You wake up in your bedroom.

Unsafe
An Interactive Fiction by Brian Chen and Jakob Weisblat
Release 1 / Serial number 190221 / Inform 7 build 6M62 (I6/v6.33 lib 6/12N) SD

Bedroom
It's your bedroom. It's not very interesting. The hall is to the east. The side door leads out of the house to the West.

On the nightstand is an iPod.

You can also see the Side Door here.

>get ipod
Taken.

>e
Hall
The hall in the middle of your house. Your bedroom is to the West. The staircase leading upwards is to the North. The back entryway is to the South. The kitchen is to the East. There is a muddy brown key hanging from a hook on the wall. You can also go down to the basement from here.

You can see a Staircase and a muddy brown key here.

* * *

>x quarter
Arkansas state quarter. Minted 2003. Looks pretty new for a 2003 quarter.

>get quarter
Taken.

>i
You are carrying:
  a quarter

>l
Study
Where you study. The hall is east.

On the desk is a dime.

You can also see the closet door here.

>n
The Closet
A small room. The hall is south.

You can see the closet door and a chest of drawers here.

>x drawers
You can't use multiple objects with that verb.

>x chest
You see nothing special about the chest of drawers.

>open chest
It isn't something you can open.

>open drawer
Which do you mean, the first drawer, the second drawer, the third drawer, the fourth drawer or the fifth drawer?

>open drawer
Which do you mean, the first drawer, the second drawer, the third drawer, the fourth drawer or the fifth drawer?

>open drawers
You can't use multiple objects with that verb.

>open first drawer
You open the first drawer, revealing a quarter.

>get quarter
Taken.

>open fourth drawer
You open the fourth drawer, revealing a quarter.

>get quarter
Taken.

>i
You are carrying:
  three quarters

>open drawers
You can't use multiple objects with that verb.

* * *

>e
Hall
The hall in the middle of your house. Your bedroom is to the West. The staircase leading upwards is to the North. The back entryway is to the South. The kitchen is to the East. There is a muddy brown key hanging from a hook on the wall. You can also go down to the basement from here.

You can see a Staircase and a muddy brown key here.

>w
Bedroom
It's your bedroom. It's not very interesting. The hall is to the east. The side door leads out into the Garden to the West.

You can see the Side Door here.

* * *

>w
The Garden
You can see the Side Door and the Shed (closed) here.

>w
Outskirts of Town
There's less town here than elsewhere. The garden is east. The space center is north. The road is west.

>w
Road
It's a road, like what people travel on. The outskirts of town are to the east. To the North you can see a fork in the road. The stream is west.

>n
Further Along the Road
More road! There's a fork in the road here. The main road goes North and South. To the West there's a parking lot.

* * *

>e
You can't go that way.

>w
Parking Lot
Where cars park, except there aren't any cars today. The road is to the east.

>w
You can't go that way.

>go through door
You can't see any such thing.

>open door
You can't see any such thing.

>x door
You can't see any such thing.

>e
Further Along the Road
More road! There's a fork in the road here. The main road goes North and South. To the West there's a parking lot.

>s
Road
It's a road, like what people travel on. The outskirts of town are to the east. To the North you can see a fork in the road. The stream is west.

>e
Outskirts of Town
There's less town here than elsewhere. The garden is east. The space center is north. The road is west.

>e
The Garden
You can see the Side Door and the Shed (closed) here.

>e
Bedroom
It's your bedroom. It's not very interesting. The hall is to the east. The side door leads out into the Garden to the West.

You can see the Side Door here.

>e
Hall
The hall in the middle of your house. Your bedroom is to the West. The staircase leading upwards is to the North. The back entryway is to the South. The kitchen is to the East. There is a muddy brown key hanging from a hook on the wall.

You can see a Staircase and a muddy brown key here.

>s
Back Entryway
The back entryway to your house. It's a tiny room with a coat rack and a trash can being the most notable scenery. The hall is to the North, the backyard to the South.

You can see the back door and a blue key here.

>e
You can't go that way.

* * *

>w
You can't go that way.

>n
Hall
The hall in the middle of your house. Your bedroom is to the West. The staircase leading upwards is to the North. The back entryway is to the South. The kitchen is to the East. There is a muddy brown key hanging from a hook on the wall.

You can see a Staircase and a muddy brown key here.

>e
Kitchen
You can see a toaster, a cabinet (closed), a refrigerator (closed) and a stool here.

>w
Hall
The hall in the middle of your house. Your bedroom is to the West. The staircase leading upwards is to the North. The back entryway is to the South. The kitchen is to the East. There is a muddy brown key hanging from a hook on the wall.

You can see a Staircase and a muddy brown key here.

>w
Bedroom
It's your bedroom. It's not very interesting. The hall is to the east. The side door leads out into the Garden to the West.

You can see the Side Door here.

>e
Hall
The hall in the middle of your house. Your bedroom is to the West. The staircase leading upwards is to the North. The back entryway is to the South. The kitchen is to the East. There is a muddy brown key hanging from a hook on the wall.

You can see a Staircase and a muddy brown key here.

>go up stairs
I only understood you as far as wanting to go up.

>go up
Upstairs Hall
The second floor of your house. Stairs lead down. The study is west, and the bathroom is east.

You can see a Staircase here.

>go through stairs
Hall
The hall in the middle of your house. Your bedroom is to the West. The staircase leading upwards is to the North. The back entryway is to the South. The kitchen is to the East. There is a muddy brown key hanging from a hook on the wall.

You can see a Staircase and a muddy brown key here.

>u
Upstairs Hall
The second floor of your house. Stairs lead down. The study is west, and the bathroom is east.

You can see a Staircase here.

>w
Study
Where you study. The hall is east.

On the desk are a dime and a quarter.

You can also see the closet door here.

>e
Upstairs Hall
The second floor of your house. Stairs lead down. The study is west, and the bathroom is east.

You can see a Staircase here.

>d
Hall
The hall in the middle of your house. Your bedroom is to the West. The staircase leading upwards is to the North. The back entryway is to the South. The kitchen is to the East. There is a muddy brown key hanging from a hook on the wall.

You can see a Staircase and a muddy brown key here.

>w
Bedroom
It's your bedroom. It's not very interesting. The hall is to the east. The side door leads out into the Garden to the West.

You can see the Side Door here.

* * *

>e
Hall
The hall in the middle of your house. Your bedroom is to the West. The staircase leading upwards is to the North. The back entryway is to the South. The kitchen is to the East. There is a muddy brown key hanging from a hook on the wall.

You can see a Staircase and a muddy brown key here.

>n
Upstairs Hall
The second floor of your house. Stairs lead down. The study is west, and the bathroom is east.

You can see a Staircase here.

>s
You can't go that way.

>d
Hall
The hall in the middle of your house. Your bedroom is to the West. The staircase leading upwards is to the North. The back entryway is to the South. The kitchen is to the East. There is a muddy brown key hanging from a hook on the wall.

You can see a Staircase and a muddy brown key here.

* * *

>w
Bedroom
It's your bedroom. It's not very interesting. The hall is to the east. The side door leads out into the Garden to the West.

You can see the Side Door here.

>undo
Hall
[Previous turn undone.]

>undo
Bedroom
[Previous turn undone.]

* * *

Unsafe
An Interactive Fiction by Brian Chen and Jakob Weisblat
Release 1 / Serial number 190223 / Inform 7 build 6M62 (I6/v6.33 lib 6/12N) SD

Bedroom
It's your bedroom. It's not very interesting. The hall is to the east. The side door (closed) leads out of the house to the West. You're lying in your bed, just having woken up.

On the nightstand is an iPod.

>e / s / take blue key / unlock door with blue key / open door / s / take stick / n / n / e / open fridge / take fish / w / d / w / w / w / w
I only understood you as far as wanting to (go) e.

>w
You can't go through the Side Door because it's closed.

>e
Hall
The hall in the middle of your house. Your bedroom is to the West. The staircase leading upwards is to the North. The back entryway is to the South. The kitchen is to the East. There is a muddy brown key hanging from a hook on the wall. You can also go down to the basement from here.

You can see a Staircase and a muddy brown key here.

>s
Back Entryway
The back entryway to your house. It's a tiny room with a coat rack and a trash can being the most notable scenery. There is a Toyota key tied to the coat rack. The hall is to the North, the backyard to the South.

You can see the back door, a blue key, a right running shoe and a Toyota key here.

>take blue key
Taken.

>unlock door with blue key
You unlock the back door.

>open door
You open the back door.

>s
Backyard
Your backyard is so well-manicured that all it contains is grass and a stick. Your house is to the north.

You can see the back door and a stick here.

>tkae stick
That's not a verb I recognise.

>n
Back Entryway
The back entryway to your house. It's a tiny room with a coat rack and a trash can being the most notable scenery. There is a Toyota key tied to the coat rack. The hall is to the North, the backyard to the South.

You can see the back door, a right running shoe and a Toyota key here.

>s
Backyard
Your backyard is so well-manicured that all it contains is grass and a stick. Your house is to the north.

You can see the back door and a stick here.

>take stick
Taken.

>n
Back Entryway
The back entryway to your house. It's a tiny room with a coat rack and a trash can being the most notable scenery. There is a Toyota key tied to the coat rack. The hall is to the North, the backyard to the South.

You can see the back door, a right running shoe and a Toyota key here.

>n
Hall
The hall in the middle of your house. Your bedroom is to the West. The staircase leading upwards is to the North. The back entryway is to the South. The kitchen is to the East. There is a muddy brown key hanging from a hook on the wall. You can also go down to the basement from here.

You can see a Staircase and a muddy brown key here.

>e
Kitchen
You can see a toaster, a cabinet (closed), a refrigerator (closed) and a stool here.

* * *

>get fish
Taken.

>w
Hall
The hall in the middle of your house. Your bedroom is to the West. The staircase leading upwards is to the North. The back entryway is to the South. The kitchen is to the East. There is a muddy brown key hanging from a hook on the wall. You can also go down to the basement from here.

You can see a Staircase and a muddy brown key here.

>d
Basement
The dark basement of your house. The hall is upstairs. The Tunnel of Extraction is to the west.

You can see The Tunnel of Extraction, a vat (closed) and a key cabinet (in which is a small metal key) here.

>w
Abandoned Warehouse
The warehouse is old and abandoned. It is big and extends south. Not much more to say. The Road is to the North. The Tunnel of Extraction is below. There are holes in the wall to the East and West.

You can see The Tunnel of Extraction here.

* * *

>w
As you walk into the woods, a large grizzly bear shows up, baring (bear-ing?) its teeth at you. You hastily take three steps back.
The bear seems to be guarding the entrance to the woods. Seems like it would be awfully difficult to get through here unless the bear were somehow distracted. With food, maybe?

>throw fish to bear
You throw the fish to the west. The bear looks at the fish curiously.

* * *

Unsafe
An Interactive Fiction by Brian Chen and Jakob Weisblat
Release 1 / Serial number 190223 / Inform 7 build 6M62 (I6/v6.33 lib 6/12N) SD

Bedroom
It's your bedroom. It's not very interesting. The hall is to the east. The side door (closed) leads out of the house to the West. You're lying in your bed, just having woken up.

On the nightstand is an iPod.

>get iPod
Taken.

>e
Hall
The hall in the middle of your house. Your bedroom is to the West. The staircase leading upwards is to the North. The back entryway is to the South. The kitchen is to the East. There is a muddy brown key hanging from a hook on the wall. You can also go down to the basement from here.

You can see a Staircase and a muddy brown key here.

>u
Upstairs Hall
The second floor of your house. Stairs lead down. The study is west, and the bathroom is east.

You can see a Staircase here.

* * *

>w
Study
Where you study. The hall is east.

On the desk are a dime and a quarter.

You can also see the closet door here.

>open drawer
You open the desk drawer, revealing earbuds.

>x desk
(the desk)
On the desk are a dime and a quarter.

* * *

Unsafe
An Interactive Fiction by Brian Chen and Jakob Weisblat
Release 1 / Serial number 190223 / Inform 7 build 6M62 (I6/v6.33 lib 6/12N) SD

Bedroom
It's your bedroom. It's not very interesting. The hall is to the east. The side door (closed) leads out of the house to the West. You're lying in your bed, just having woken up.

On the nightstand is an iPod.

>get ipod
Taken.

* * *

>w
Study
Where you study. The hall is east.

On the desk are a dime and a quarter.

You can also see the closet door here.

>x desk
(the desk)
It's a sturdy wooden desk. There's a drawer.

On the desk are a dime and a quarter.

* * *

>open drawer
You open the desk drawer, revealing earbuds.

>undo
Study
[Previous turn undone.]

>undo
Study
[Previous turn undone.]

>open drawer
You open the desk drawer, revealing earbuds.

>get earbuds
Taken.

>plug earbuds into ipod
You plug the earbuds into the iPod. Your favorite song starts to play through them!

>plug earbuds
You plug the earbuds into the iPod. Your favorite song starts to play through them!

>x ipod
It's an iPod touch, third-generation, maybe? It's playing your favorite song.

>put in earbuds
I didn't understand that sentence.

>wear earbuds
You put on earbuds.

>x earbuds
The earbuds are red.

>undo
Study
[Previous turn undone.]

>get earbuds
You already have that.

>undo
Study
[Previous turn undone.]

>log
That's not a verb I recognise.

* * *

Unsafe
An Interactive Fiction by Brian Chen and Jakob Weisblat
Release 1 / Serial number 190223 / Inform 7 build 6M62 (I6/v6.33 lib 6/12N) SD

Bedroom
It's your bedroom. It's not very interesting. The hall is to the east. The side door (closed) leads out of the house to the West. You're lying in your bed, just having woken up.

On the nightstand is an iPod.

>go to hall
You can't see any such thing.

>u
You can't go that way.

>undo
Bedroom
[Previous turn undone.]

>undo
You can't "undo" what hasn't been done!

>e
Hall
The hall in the middle of your house. Your bedroom is to the West. The staircase leading upwards is to the North. The back entryway is to the South. (??) The kitchen is to the East.

You can see a Staircase here.

>e
Kitchen
You can see a toaster, a cabinet (closed), a refrigerator (closed) and a stool here.

* * *

>get stool
Taken.

>w
Hall
The hall in the middle of your house. Your bedroom is to the West. The staircase leading upwards is to the North. The back entryway is to the South. (??) The kitchen is to the East.

You can see a Staircase here.

>w
Bedroom
It's your bedroom. It's not very interesting. The hall is to the east.

You can see the Side Door here.

* * *

>w
The Garden
You can see the Side Door and the Shed (closed) here.

>x shed
(the Shed)
A narrow rusty shed. The shed is really tall and you can't see above it.

>put down stool
Dropped.

* * *

>get on stool
You get onto the stool.

>x shed
(the Shed)
A narrow rusty shed. On the shed's roof, you can see a bucket.

>get bucket
Taken.

>w
(first getting off the stool)

Outskirts of Town
There's less town here than elsewhere. The garden is east. The space center is north. The road is west.

>w
Road
It's a road, like what people travel on. The outskirts of town are to the east. To the North you can see a fork in the road. The stream is west.

>n
Further Along the Road
More road! The road goes south. To the west there's a parking lot.

>get fork
You can't see any such thing.

>n
Abandoned Train Station
No trains.

>s
Further Along the Road
More road! The road goes south. To the west there's a parking lot.

>s
Road
It's a road, like what people travel on. The outskirts of town are to the east. To the North you can see a fork in the road. The stream is west.

>w
By the Stream
There's a stream, makeing whatever sound water makes. There's also a scary warning sign.

>x sign
The sign says BEWARE OF PIRANHAS.

>enter stream
Water is nice, but out here? Maybe in the privacy of your own home you'd reconsider.

>go in stream
Water is nice, but out here? Maybe in the privacy of your own home you'd reconsider.

>take water
That's hardly portable.

>w
You can't go that way.

* * *

>e
Clearing
It's very clear here. The edge of the woods is to the west. A hole that leads into the abandoned warehouse is to the east. There's a stream to the north.

>e
Abandoned Warehouse
The warehouse is old and abandoned.It is big and extends south. Not much more to say. The Road is to the North. The Tunnel of Extraction is below. There are holes in the wall to the East and West.

You can see The Tunnel of Extraction here.

>e
Town Square
You can see the Mad Scientist's Grand Entrance here.

>i
You are carrying:
  a bucket

>w
Abandoned Warehouse
The warehouse is old and abandoned.It is big and extends south. Not much more to say. The Road is to the North. The Tunnel of Extraction is below. There are holes in the wall to the East and West.

You can see The Tunnel of Extraction here.

>d
Basement
The dark basement of your house. The hall is upstairs. The Tunnel of Extraction is to the west.

You can see The Tunnel of Extraction here.

>u
Hall
The hall in the middle of your house. Your bedroom is to the West. The staircase leading upwards is to the North. The back entryway is to the South. (??) The kitchen is to the East.

You can see a Staircase here.

>e
Kitchen
You can see a toaster, a cabinet (closed) and a refrigerator (closed) here.

>w
Hall
The hall in the middle of your house. Your bedroom is to the West. The staircase leading upwards is to the North. The back entryway is to the South. (??) The kitchen is to the East.

You can see a Staircase here.

>e
Kitchen
You can see a toaster, a cabinet (closed) and a refrigerator (closed) here.

>e
You can't go that way.

>w
Hall
The hall in the middle of your house. Your bedroom is to the West. The staircase leading upwards is to the North. The back entryway is to the South. (??) The kitchen is to the East.

You can see a Staircase here.

>s
Back Entryway
The back entryway to your house. It's a tiny room with a coat rack and a trash can being the most notable scenery. The hall is to the North, the backyard to the South.

You can see the back door and a blue key here.

>s
You can't go through the back door because it's closed.

>n
Hall
The hall in the middle of your house. Your bedroom is to the West. The staircase leading upwards is to the North. The back entryway is to the South. (??) The kitchen is to the East.

You can see a Staircase here.

>w
Bedroom
It's your bedroom. It's not very interesting. The hall is to the east.

You can see the Side Door here.

>w
The Garden
You can see the Side Door, a stool and the Shed (closed) here.

>get stool
Taken.

>e
Bedroom
It's your bedroom. It's not very interesting. The hall is to the east.

You can see the Side Door here.

* * *

>w
Abandoned Warehouse
The warehouse is old and abandoned.It is big and extends south. Not much more to say. The Road is to the North. The Tunnel of Extraction is below. There are holes in the wall to the East and West.

You can see The Tunnel of Extraction here.

>x tunnel
A long, winding tunnel. It used to be used to extract minerals and stuff. Now, it's probably still useful for extracting other things.

>w
Clearing
It's very clear here. The edge of the woods is to the west. A hole that leads into the abandoned warehouse is to the east. There's a stream to the north.

>e
Abandoned Warehouse
The warehouse is old and abandoned.It is big and extends south. Not much more to say. The Road is to the North. The Tunnel of Extraction is below. There are holes in the wall to the East and West.

You can see The Tunnel of Extraction here.

* * *

>open entrance
You open the Mad Scientist's Grand Entrance.

>go through entrance
Mad Scientist's house
You can see the Mad Scientist's Grand Entrance here.

* * *

Unsafe
An Interactive Fiction by Brian Chen and Jakob Weisblat
Release 1 / Serial number 190223 / Inform 7 build 6M62 (I6/v6.33 lib 6/12N) SD

Bedroom
It's your bedroom. It's not very interesting. The hall is to the east. The side door (closed) leads out of the house to the West. You're lying in your bed, just having woken up.

On the nightstand is an iPod.

>i
You are carrying:
  pants (being worn)
  underwear (being worn)
  socks (being worn)
  a shirt (being worn)
  shoes (being worn)
  a belt (being worn)
  a hat (being worn)
  a jacket (being worn)

>x me
As good-looking as ever.

>take off belt
You take off the belt.

>take off all
You can't see any such thing.

>x me
As good-looking as ever.

* * *

Unsafe
An Interactive Fiction by Brian Chen and Jakob Weisblat
Release 1 / Serial number 190223 / Inform 7 build 6M62 (I6/v6.33 lib 6/12N) SD

Bedroom
It's your bedroom. It's not very interesting. The hall is to the east. The side door (closed) leads out of the house to the West. You're lying in your bed, just having woken up.

On the nightstand is an iPod.

>l
Bedroom
It's your bedroom. It's not very interesting. The hall is to the east. The side door leads out of the house to the West. 

On the nightstand is an iPod.

You can also see the Side Door here.

>x ipod
It's an iPod touch, third-generation, maybe?

* * *

Unsafe
An Interactive Fiction by Brian Chen and Jakob Weisblat
Release 1 / Serial number 190223 / Inform 7 build 6M62 (I6/v6.33 lib 6/12N) SD

Bedroom
It's your bedroom. It's not very interesting. The hall is to the east. The side door (closed) leads out of the house to the West. You're lying in your bed, just having woken up.

On the nightstand is an iPod.

>open door
You open the Side Door.

* * *

>w
The Garden
You can see the Side Door and the Shed (closed) here.

>e
Bedroom
It's your bedroom. It's not very interesting. The hall is to the east. The side door leads out into the Garden to the West.

You can see the Side Door here.

>e
Hall
The hall in the middle of your house. Your bedroom is to the West. The staircase leading upwards is to the North. The back entryway is to the South. The kitchen is to the East. There is a muddy brown key hanging from a hook on the wall. You can also go down to the basement from here.

You can see a Staircase and a muddy brown key here.

* * *

>w
Bedroom
It's your bedroom. It's not very interesting. The hall is to the east. The side door leads out into the Garden to the West.

You can see the Side Door here.

>w
The Garden
You can see the Side Door and the Shed (closed) here.

>put stool down
Dropped.

>get on stool
You get onto the stool.

* * *

>w
Road
It's a road, like what people travel on. The outskirts of town are to the east. To the North you can see a fork in the road. The stream is west.

>w
By the Stream
There's a stream, makein whatever sound water makes. There's also a scary warning sign.

>dip bucket in stream
You dip the bucket in the water, coming out with a bucketful of water and a few.. pirhanas?!

>e
Road
It's a road, like what people travel on. The outskirts of town are to the east. To the North you can see a fork in the road. The stream is west.

>s
Abandoned Warehouse
The warehouse is old and abandoned. It is big and extends south. Not much more to say. The Road is to the North. The Tunnel of Extraction is below. There are holes in the wall to the East and West.

You can see The Tunnel of Extraction here.

>d
Basement
The dark basement of your house. The hall is upstairs. The Tunnel of Extraction is to the west.

You can see The Tunnel of Extraction and a vat (closed) here.

>u
Hall
The hall in the middle of your house. Your bedroom is to the West. The staircase leading upwards is to the North. The back entryway is to the South. The kitchen is to the East. There is a muddy brown key hanging from a hook on the wall. You can also go down to the basement from here.

You can see a Staircase and a muddy brown key here.

>u
Upstairs Hall
The second floor of your house. Stairs lead down. The study is west, and the bathroom is east.

You can see a Staircase here.

>e
Bathroom
It's just a bathroom.

You can see a mirror, a medicine cabinet (closed) and a bathtub here.

>plug bathtub
You plug the drain.

>put water in tub
You can't see any such thing.

>put bucketful in tub
You can't see any such thing.

>x bucket
In the bucket is a bucketful of piranha-infested water.

>turn on faucet
It isn't something you can switch.

* * *

>n
Further Along the Road
More road! There's a fork in the road here. The main road goes North and South. To the West there's a parking lot.

>pull fork
You try to pull the fork out of the road, but it's pretty stuck. Your hand slips off the fork just as you feel it has dislodged slightly from the road.

>pull fork
Nothing obvious happens.

>take fork
Taken.

* * *

>pull fork
You try to pull the fork out of the road, but it's pretty stuck. Your hand slips off the fork just as you feel it has dislodged slightly from the road.

>take fork
Taken.

>s
Road
It's a road, like what people travel on. The outskirts of town are to the east. To the North you can see a fork in the road. The stream is west.

>s
Abandoned Warehouse
The warehouse is old and abandoned. It is big and extends south. Not much more to say. The Road is to the North. The Tunnel of Extraction is below. There are holes in the wall to the East and West.

You can see The Tunnel of Extraction here.

* * *

>u
Hall
The hall in the middle of your house. Your bedroom is to the West. The staircase leading upwards is to the North. The back entryway is to the South. The kitchen is to the East. There is a muddy brown key hanging from a hook on the wall. You can also go down to the basement from here.

You can see a Staircase and a muddy brown key here.

>e
Kitchen
You can see a toaster, a cabinet (closed), a refrigerator (closed) and a stool here.

>open cabinet
You open the cabinet, revealing a top drawer, a middle drawer and a bottom drawer.

>l
Kitchen
You can see a toaster, a cabinet (in which are a top drawer (closed), a middle drawer (closed) and a bottom drawer (closed)), a refrigerator (closed) and a stool here.

>undo
Kitchen
[Previous turn undone.]

>open middle drawer
You open the middle drawer, revealing a big tupperware.

>open bread box
You can't see any such thing.

>get bread
You can't see any such thing.

>get bread
You can't see any such thing.

>get loaf
You can't see any such thing.

>x loaf
You can't see any such thing.

>undo
Kitchen
[Previous turn undone.]

>x toaster
The toaster turns bread into toast. There is a button on the front of the toaster labelled "TOAST". 
The toaster is unplugged.

>put bread in toaster
You can't see any such thing.

>x toaster
The toaster turns bread into toast. There is a button on the front of the toaster labelled "TOAST". 
The toaster is unplugged.

>press toast
Nothing happens. What did you expect from an unplugged toaster??

>press button
Nothing happens. What did you expect from an unplugged toaster??

>plug in toaster
You plug in the toaster.

>x toaster
The toaster turns bread into toast. There is a button on the front of the toaster labelled "TOAST". 
The toaster is plugged in.

>put bread in toaster
You can't see any such thing.

>put bread in toaster
You can't see any such thing.

>x toaster
The toaster turns bread into toast. There is a button on the front of the toaster labelled "TOAST". 
The toaster is plugged in.

>press button
Nothing happens. This isn't a magical toaster - it turns BREAD into toast, not air.

>wait
Time passes.

>put fork in toaster
That's not what you're supposed to put in a toaster!

>restart
Are you sure you want to restart?

>test toaster
Please answer yes or no.

* * *

>restart
Are you sure you want to restart?

>yes
You wake up in your bedroom.

Unsafe
An Interactive Fiction by Brian Chen and Jakob Weisblat
Release 1 / Serial number 190221 / Inform 7 build 6M62 (I6/v6.33 lib 6/12N) SD

Bedroom
It's your bedroom. It's not very interesting. The hall is to the east. The side door leads out into the Garden to the West.

You can see the Side Door here.

* * *

>put fork in toaster
Please give one of the answers above.

Would you like to RESTART, RESTORE a saved game, QUIT or UNDO the last command?

Please give one of the answers above.

Would you like to RESTART, RESTORE a saved game, QUIT or UNDO the last command?

>restart
You wake up in your bedroom.

Unsafe
An Interactive Fiction by Brian Chen and Jakob Weisblat
Release 1 / Serial number 190221 / Inform 7 build 6M62 (I6/v6.33 lib 6/12N) SD

Bedroom
It's your bedroom. It's not very interesting. The hall is to the east. The side door leads out into the Garden to the West.

You can see the Side Door here.

>e
Hall
The hall in the middle of your house. Your bedroom is to the West. The staircase leading upwards is to the North. The back entryway is to the South. The kitchen is to the East. There is a muddy brown key hanging from a hook on the wall. You can also go down to the basement from here.

You can see a Staircase and a muddy brown key here.

>undo
Bedroom
[Previous turn undone.]

* * *

>w
The Garden
You can see the Side Door and the Shed (closed) here.

>undo
Bedroom
[Previous turn undone.]

>e
Hall
The hall in the middle of your house. Your bedroom is to the West. The staircase leading upwards is to the North. The back entryway is to the South. The kitchen is to the East. There is a muddy brown key hanging from a hook on the wall. You can also go down to the basement from here.

You can see a Staircase and a muddy brown key here.

* * *

>w
By the Stream
There's a stream, makein whatever sound water makes. There's also a scary warning sign.

>dip bucket in water
You dip the bucket in the water, coming out with a bucketful of water and a few.. pirhanas?!

>x bucket
In the bucket is a pirhana-infested water.

>put bucket in stream
You dip the bucket in the water, coming out with a bucketful of water and a few.. pirhanas?!

>put bucket in water
(the stream)
You dip the bucket in the water, coming out with a bucketful of water and a few.. pirhanas?!

>pour
That's not a verb I recognise.

>plug the water
I didn't understand that sentence.

>plug in the water
(the stream)
You can't plug in the stream.

* * *

Unsafe
An Interactive Fiction by Brian Chen and Jakob Weisblat
Release 1 / Serial number 190223 / Inform 7 build 6M62 (I6/v6.33 lib 6/12N) SD

Bedroom
It's your bedroom. It's not very interesting. The hall is to the east. The side door (closed) leads out of the house to the West. You're lying in your bed, just having woken up.

On the nightstand is an iPod.

>tesdt
That's not a verb I recognise.

>test
>--> The following tests are available:
'test platform'
'test toaster'
'test fly'
'test space'
'test candle'
'test cage'
'test piranhas'
'test trees'
'test moose'
'test bear'
'test glue'

>test wasps
>--> The following tests are available:
'test platform'
'test toaster'
'test fly'
'test space'
'test candle'
'test cage'
'test piranhas'
'test trees'
'test moose'
'test bear'
'test glue'

* * *

>i
Please give one of the answers above.

Would you like to RESTART, RESTORE a saved game, QUIT or UNDO the last command?

* * *

>undo
Woods
[Previous turn undone.]

>undo
Edge of the Woods
[Previous turn undone.]

>[24] attack bear
You can't see any such thing.

>undo
Edge of the Woods
[Previous turn undone.]

>undo
Edge of the Woods
[Previous turn undone.]

>[23] w
You're too scared of the bear to go there.

The bear flops onto its full stomach and starts snoring.

>[24] attack bear
You can't see any such thing.

>undo
Edge of the Woods
[Previous turn undone.]

>undo
Edge of the Woods
[Previous turn undone.]

>[24] attack bear
You can't see any such thing.

* * *

>undo
Edge of the Woods
[Previous turn undone.]

>undo
Edge of the Woods
[Previous turn undone.]

>[22] z
Time passes.

The bear rubs its belly sleepily. Maybe it'll fall asleep soon.

>[23] w
You're too scared of the bear to go there.

The bear flops onto its full stomach and starts snoring.

>[24] attack bear
You can't see any such thing.

>undo
Edge of the Woods
[Previous turn undone.]

>w
Woods
There's lots of trees, in particular, an ash tree, an elm tree, and a pine tree. The edge of the woods is to the east. Going south, you can see signs for a hunting lodge.

You can see a grizzly bear here.

>w
Too many trees. You'd get lost.

>e
Edge of the Woods
The woods start here and extend to the west. There's a clearing to the east.

* * *

>undo
Woods
[Previous turn undone.]

>w
Too many trees. You'd get lost.

>s
Hunting Grounds
Where hunters hunt things, as long as it's the right season. The woods are to the north. You can head into the Hunting Lodge to the south.

You can see the hunting lodge entrance here.

>s
You can't go through the hunting lodge entrance because it's closed.

>open door
You can't see any such thing.

>open entrance
You open the hunting lodge entrance.

>s
Hunting Lodge
Where hunters rest or something. One wall is covered in animal heads - a deer, a moose, a lion(!). Kinda creepy, to be honest. The exit is north.

You can see the hunting lodge entrance, a moose head, a deer head, a lion head and a poster here.

>x poster
A poster reading "Hunting season begins in 5 weeks!"

>n
Hunting Grounds
Where hunters hunt things, as long as it's the right season. The woods are to the north. You can head into the Hunting Lodge to the south.

You can see the hunting lodge entrance here.

>n
Woods
There's lots of trees, in particular, an ash tree, an elm tree, and a pine tree. The edge of the woods is to the east. Going south, you can see signs for a hunting lodge.

You can see a grizzly bear here.

>e
Edge of the Woods
The woods start here and extend to the west. There's a clearing to the east.

* * *

>w
Abandoned Warehouse
The warehouse is old and abandoned. It is big and extends south. Not much more to say. The Road is to the North. The Tunnel of Extraction is below. There are holes in the wall to the East and West.

You can see The Tunnel of Extraction here.

>d
Basement
The dark basement of your house. The hall is upstairs. The Tunnel of Extraction is to the west.

You can see The Tunnel of Extraction, a vat (closed) and a key cabinet (in which is a small metal key) here.

>u
Hall
The hall in the middle of your house. Your bedroom is to the West. The staircase leading upwards is to the North. The back entryway is to the South. The kitchen is to the East. There is a muddy brown key hanging from a hook on the wall. You can also go down to the basement from here.

You can see a Staircase and a muddy brown key here.

>w
Bedroom
It's your bedroom. It's not very interesting. The hall is to the east. The side door (closed) leads out of the house to the West. 

On the nightstand is an iPod.

* * *

>undo
Hunting Lodge
[Previous turn undone.]

>x poster
A poster reading "Hunting Season is Now""

* * *

>7
That's not a verb I recognise.

>undo 15
That's not a verb I recognise.

>undo
A Spooky Lair
[Previous turn undone.]

>undo
A Spooky Lair
[Previous turn undone.]

>undo
A Spooky Lair
[Previous turn undone.]

>[22] lock cage with small key
You can't see any such thing.

>undo
A Spooky Lair
[Previous turn undone.]

>undo
A Spooky Lair
[Previous turn undone.]

>[21] close cage
You can't see any such thing.

>[22] lock cage with small key
You can't see any such thing.

>undo
A Spooky Lair
[Previous turn undone.]

>undo
A Spooky Lair
[Previous turn undone.]

>[20] put mouse in cage
You can't see any such thing.

>[21] close cage
You can't see any such thing.

>[22] lock cage with small key
You can't see any such thing.

>undo
A Spooky Lair
[Previous turn undone.]

>clear
What do you want to clear?

* * *

Unsafe
An Interactive Fiction by Brian Chen and Jakob Weisblat
Release 1 / Serial number 190223 / Inform 7 build 6M62 (I6/v6.33 lib 6/12N) SD

Bedroom
It's your bedroom. It's not very interesting. The hall is to the east. The side door (closed) leads out of the house to the West. You're lying in your bed, just having woken up.

On the nightstand is an iPod.

>test candle
(Testing.)

>[1] e

Hall
The hall in the middle of your house. Your bedroom is to the West. The staircase leading upwards is to the North. The back entryway is to the South. (??) The kitchen is to the East.

You can see a Staircase here.

>[2] e

Kitchen
You can see a toaster, a cabinet (closed), a refrigerator (closed) and a stool here.

>[3] get stool
Taken.

>[4] w

Hall
The hall in the middle of your house. Your bedroom is to the West. The staircase leading upwards is to the North. The back entryway is to the South. (??) The kitchen is to the East.

You can see a Staircase here.

>[5] n

Upstairs Hall
The second floor of your house. Stairs lead down. The study is west, and the bathroom is east.

You can see a Staircase here.

>[6] e

Bathroom
It's just a bathroom.

You can see a medicine cabinet (closed) here.

>[7] put stool down
Dropped.

>[8] get on stool
You get onto the stool.

>[9] open cabinet
You open the medicine cabinet, revealing a can of hair gel.

>[10] get gel
Taken.

>[11] put on gel
Carefully, you spray the hair gel on your head while looking on the mirror. It looks great! You look very fancy.

>[12] w
(first getting off the stool)

Upstairs Hall
The second floor of your house. Stairs lead down. The study is west, and the bathroom is east.

You can see a Staircase here.

>[13] d

Hall
The hall in the middle of your house. Your bedroom is to the West. The staircase leading upwards is to the North. The back entryway is to the South. (??) The kitchen is to the East.

You can see a Staircase here.

>[14] d

Basement
The dark basement of your house. The hall is upstairs. The Tunnel of Extraction is to the west.

You can see The Tunnel of Extraction here.

>[15] w

Abandoned Warehouse
The warehouse is old and abandoned.It is big and extends south. Not much more to say. The Road is to the North. The Tunnel of Extraction is below. There are holes in the wall to the East and West.

You can see The Tunnel of Extraction here.

>[16] s

A Spooky Lair
A lair in which a demonic ritual might be held. There is a table with a pentagram drawn on it.

On the table is a candle.

You can also see four snakes here.

>[17] get candle
You touch the candle. The flame leaps onto your hair. Boom!
You've reached one of this game's 14 endings! In that game you used 17 moves. The optimal number of moves is 17.
Great job, you got the optimal number of moves!

    *** You have died ***

Would you like to RESTART, RESTORE a saved game, QUIT or UNDO the last command?

>restart
You wake up in your bedroom.

Unsafe
An Interactive Fiction by Brian Chen and Jakob Weisblat
Release 1 / Serial number 190221 / Inform 7 build 6M62 (I6/v6.33 lib 6/12N) SD

Bedroom
It's your bedroom. It's not very interesting. The hall is to the east.

You can see the Side Door here.

>e
Hall
The hall in the middle of your house. Your bedroom is to the West. The staircase leading upwards is to the North. The back entryway is to the South. (??) The kitchen is to the East.

You can see a Staircase here.

* * *

>open fridge
You open the refrigerator, revealing a fish and a pie.

>take fish
Taken.

>w
Hall
The hall in the middle of your house. Your bedroom is to the West. The staircase leading upwards is to the North. The back entryway is to the South. (??) The kitchen is to the East.

You can see a Staircase here.

>d
Basement
The dark basement of your house. The hall is upstairs. The Tunnel of Extraction is to the west.

You can see The Tunnel of Extraction here.

* * *

>w
Abandoned Warehouse
The warehouse is old and abandoned.It is big and extends south. Not much more to say. The Road is to the North. The Tunnel of Extraction is below. There are holes in the wall to the East and West.

You can see The Tunnel of Extraction here.

>w
clearing

* * *

I beg your pardon?

* * *

>open car
You open the blue car.

>enter car
You get into the blue car.

>q
Are you sure you want to quit?

* * *

>e
That would be unsafe. You should close the door.

>n
That would be unsafe. You should close the door.

>close door
You can't see any such thing.

* * *

>open car
You open the blue car.

>get in car
You get into the blue car.

>get in blue car
But you're already in the blue car.

>e
Further Along the Road (in the blue car)
More road! There's a fork in the road here. The main road goes North and South. To the West there's a parking lot.

>x car
It's your car. Bluish-gray paint, steering wheel, headlights. All that.

>close car
You close the blue car.

It is now pitch dark in here!

* * *

>open car
You open the blue car.

>open your car
You can't see any such thing.

>i
You are carrying:
  a car key
  pants (being worn)
  underwear (being worn)
  socks (being worn)
  a shirt (being worn)
  work shoes (being worn)
  a belt (being worn)
  a hat (being worn)
  a jacket (being worn)

>open car
(the car key)
That's already open.

>l
Parking Lot
Where cars park. You see your boxy blue-gray car in the corner of the lot. The road is to the east.

You can see a blue car (empty) here.

>get in car
(the car key)
That's not something you can enter.

>showme car
(the car key)
car key - thing
location: carried by yourself in the Parking Lot
singular-named, improper-named; unlit, inedible, portable, handled, tub-relevant; list grouping key: none
printed name: "car key"
printed plural name: none
indefinite article: none
description: none
initial appearance: none

* * *

>undo
Further Along the Road
[Previous turn undone.]

>drive around boom gates
try going north

* * *

>w
Parking Lot
Where cars park, except there aren't any cars today. The road is to the east.

* * *

Unsafe
An Interactive Fiction by Brian Chen and Jakob Weisblat
Release 1 / Serial number 190223 / Inform 7 build 6M62 (I6/v6.33 lib 6/12N) SD

Bedroom
It's your bedroom. It's not very interesting. The hall is to the east. The side door (closed) leads out of the house to the West. You're lying in your bed, just having woken up.

On the nightstand is an iPod.

>test edge
(Testing.)

>[1] take ipod
Taken.

>[2] e

Hall
The hall in the middle of your house. Your bedroom is to the West. The staircase leading upwards is to the North. The back entryway is to the South. The kitchen is to the East. There is a muddy brown key hanging from a hook on the wall. You can also go down to the basement from here.

You can see a Staircase and a muddy brown key here.

>[3] u

Upstairs Hall
The second floor of your house. Stairs lead down. The study is west, and the bathroom is east.

You can see a Staircase here.

>[4] w

Study
Where you study. The hall is east.

On the desk are a dime and a quarter.

You can also see the closet door here.

>[5] open drawer
You open the desk drawer, revealing earbuds.

>[6] get earbuds
Taken.

>[7] e

Upstairs Hall
The second floor of your house. Stairs lead down. The study is west, and the bathroom is east.

You can see a Staircase here.

>[8] d

Hall
The hall in the middle of your house. Your bedroom is to the West. The staircase leading upwards is to the North. The back entryway is to the South. The kitchen is to the East. There is a muddy brown key hanging from a hook on the wall. You can also go down to the basement from here.

You can see a Staircase and a muddy brown key here.

>[9] d

Basement
The dark basement of your house. The hall is upstairs. The Tunnel of Extraction is to the west.

You can see The Tunnel of Extraction, a vat (closed) and a key cabinet (in which is a small metal key) here.

>[10] w

Abandoned Warehouse
The warehouse is old and abandoned. It is big and extends south. Not much more to say. The Road is to the North. The Tunnel of Extraction is below. There are holes in the wall to the East and West.

You can see The Tunnel of Extraction here.

>[11] n

Road
It's a road, like what people travel on. The outskirts of town are to the east. To the North you can see a fork in the road. The stream is west.

>[12] n

Further Along the Road
More road! There's a fork in the road here. The main road goes North and South. To the West there's a parking lot.

>[13] n

Abandoned Train Station
No trains.

>put in earbuds
I didn't understand that sentence.

>undo
Abandoned Train Station
[Previous turn undone.]

>wear earbuds
You put on earbuds.

>put earbuds in ipod
You plug the earbuds into the iPod. Your favorite song starts to play through them!

>plug earbuds into ipod
You plug the earbuds into the iPod. Your favorite song starts to play through them!

>n
You can't go that way.

* * *

>e
Control Room
Where things get controlled.

You can see the CALL TRAIN button here.

>press button
(the CALL TRAIN button)
You press the CALL TRAIN button. An electronic voice informs you, "The train will be here any minute now." That was easy.

>w
Abandoned Train Station
No trains.

>stand on edge
You get onto the edge of the platform.

A train enters the station while you're jamming to the music, and you trip and fall into the train tracks in front of it. That was really dumb.
You've reached one of this game's 14 endings! In that game you used 21 moves. The optimal number of moves is 37.
Uh-oh, the puzzle is broken! Send us an email!

    *** You have died ***

Would you like to RESTART, RESTORE a saved game, QUIT or UNDO the last command?

>restart
Unsafe
An Interactive Fiction by Brian Chen and Jakob Weisblat
Release 1 / Serial number 190222 / Inform 7 build 6M62 (I6/v6.33 lib 6/12N) SD

Bedroom
It's your bedroom. It's not very interesting. The hall is to the east. The side door (closed) leads out of the house to the West. You're lying in your bed, just having woken up.

On the nightstand is an iPod.

>test platform
(Testing.)

>[1] get ipod
Taken.

>[2] e

Hall
The hall in the middle of your house. Your bedroom is to the West. The staircase leading upwards is to the North. The back entryway is to the South. The kitchen is to the East. There is a muddy brown key hanging from a hook on the wall. You can also go down to the basement from here.

You can see a Staircase and a muddy brown key here.

>[3] u

Upstairs Hall
The second floor of your house. Stairs lead down. The study is west, and the bathroom is east.

You can see a Staircase here.

>[4] w

Study
Where you study. The hall is east.

On the desk are a dime and a quarter.

You can also see the closet door here.

>[5] open drawer
You open the desk drawer, revealing earbuds.

>[6] get earbuds
Taken.

>[7] e

Upstairs Hall
The second floor of your house. Stairs lead down. The study is west, and the bathroom is east.

You can see a Staircase here.

>[8] d

Hall
The hall in the middle of your house. Your bedroom is to the West. The staircase leading upwards is to the North. The back entryway is to the South. The kitchen is to the East. There is a muddy brown key hanging from a hook on the wall. You can also go down to the basement from here.

You can see a Staircase and a muddy brown key here.

>[9] d

Basement
The dark basement of your house. The hall is upstairs. The Tunnel of Extraction is to the west.

You can see The Tunnel of Extraction, a vat (closed) and a key cabinet (in which is a small metal key) here.

>[10] w

Abandoned Warehouse
The warehouse is old and abandoned. It is big and extends south. Not much more to say. The Road is to the North. The Tunnel of Extraction is below. There are holes in the wall to the East and West.

You can see The Tunnel of Extraction here.

>[11] n

Road
It's a road, like what people travel on. The outskirts of town are to the east. To the North you can see a fork in the road. The stream is west.

>[12] n

Further Along the Road
More road! There's a fork in the road here. The main road goes North and South. To the West there's a parking lot.

>[13] n

Abandoned Train Station
No trains.

>w
You can't go that way.

>undo
Abandoned Train Station
[Previous turn undone.]

>e
Control Room
Where things get controlled.

You can see the CALL TRAIN button here.

>press CALL TRAIN
You press the CALL TRAIN button. An electronic voice informs you, "The train will be here any minute now." That was easy.

>w
Abandoned Train Station
No trains.

>put in earbuds
I didn't understand that sentence.

>put in earbuds
I didn't understand that sentence.

>put on earbuds
You put on earbuds.

>put earbuds in ipod
You plug the earbuds into the iPod. Your favorite song starts to play through them!

>stand on edge
You get onto the edge of the platform.

A train enters the station while you're jamming to the music, and you trip and fall into the train tracks in front of it. That was really dumb.
You've reached one of this game's 14 endings! In that game you used 19 moves. The optimal number of moves is 37.
Uh-oh, the puzzle is broken! Send us an email!

    *** You have died ***

Would you like to RESTART, RESTORE a saved game, QUIT or UNDO the last command?

>undo
Abandoned Train Station
[Previous turn undone.]

>stand on platform
You get onto the edge of the platform.

A train enters the station while you're jamming to the music, and you trip and fall into the train tracks in front of it. That was really dumb.
You've reached one of this game's 14 endings! In that game you used 19 moves. The optimal number of moves is 37.
Uh-oh, the puzzle is broken! Send us an email!

    *** You have died ***

Would you like to RESTART, RESTORE a saved game, QUIT or UNDO the last command?

>restart
Unsafe
An Interactive Fiction by Brian Chen and Jakob Weisblat
Release 1 / Serial number 190222 / Inform 7 build 6M62 (I6/v6.33 lib 6/12N) SD

Bedroom
It's your bedroom. It's not very interesting. The hall is to the east. The side door (closed) leads out of the house to the West. You're lying in your bed, just having woken up.

On the nightstand is an iPod.

* * *

Unsafe
An Interactive Fiction by Brian Chen and Jakob Weisblat
Release 1 / Serial number 190223 / Inform 7 build 6M62 (I6/v6.33 lib 6/12N) SD

Bedroom
It's your bedroom. It's not very interesting. The hall is to the east. The side door (closed) leads out of the house to the West. You're lying in your bed, just having woken up.

On the nightstand is an iPod.

>test fly
(Testing.)

>[1] open door
You open the Side Door.

>[2] w

The Garden
You can see the Side Door and the Shed (closed) here.

>[3] w

Outskirts of Town
There's less town here than elsewhere. The garden is east. The space center is north. The road is west.

>[4] n

Space Center

>[5] n

Launch Pad
You can see a spaceship (closed) here.

>[6] open spaceship
You open the spaceship, revealing an ON button, a LAUNCH button, a spacesuit and a helmet.

>[7] get in spaceship
You get into the spaceship.

In the spaceship you can see an ON button, a LAUNCH button, a spacesuit and a helmet.

>[8] close spaceship
You close the spaceship.

>[9] press on
You press the ON button. All around you dials spin and lights blink.

A dialog appears on the screen: WARNING: LOW FUEL. SAY "confirm" to continue. Mission abort HIGHLY recommended.

>[10] say confirm
(to the computer)
The dialog on the screen goes away. The screen now reads READY FOR LAUNCH.

>[11] press launch
The computer counts down: "3... 2... 1... LAUNCHING". 

 The world around you starts to disappear into the smoke emmitted from the rocket engine. You feel yourself pressed into the seat as the spaceship lifts off toward the sky. 

The computer says "This ship is equipped with an auto spacesuit. Simply say SUIT UP and the ship will automatically put your space suit on you so you can go out into space."

>[12] wait
Time passes.

The computer announces: "Auto pilot has engaged. Say CANCEL to fly the ship yourself. Auto pilot has detected that the fuel level is low and will land the ship momentarily."

>[13] say cancel
(to the computer)
The autopilot is disabled.

>[14] wait
Time passes.

>[15] wait
Time passes.

With a putter then a WHOOSH, the ship runs out of fuel. You don't have much choice but to grip the controls and try to fly it like a plane.

>[16] wait
Time passes.

AAAAAAAAAAAAAAAAAAAAAAAAAAAAAAAAAAAAAAAAAAAAAAAAAAAAAAAAAAAAAAAAAAAAAAAAAAAAAAAA!
The ship barrels toward the ground at an alarming rate.

>[17] wait
Time passes.

AAAAAAAAAAAAAAAAAAAAAAAAAAAAAAAAAAAAAAAAAAAAAAAAAAAAAAAAAAAAAAAAAAAAAAAAAAAAAAAA!
The ship barrels toward the ground at an alarming rate.

>say test
(to yourself)
There is no reply.

* * *

>s
You would have to get out of the spaceship first.

The computer announces: "Auto pilot has engaged. Say CANCEL to fly the ship yourself. Auto pilot has detected that the fuel level is low and will land the ship momentarily."

>n
You would have to get out of the spaceship first.

>u
You would have to get out of the spaceship first.

The ship stops ascending as the auto pilot takes over. You start to fall toward earth.

>d
You would have to get out of the spaceship first.

>open door
You can't see any such thing.

>open ship
You can't see any such thing.

>open spaceship
The doors of the spaceship don't open while you're in the atmosphere.

The spaceship lands in a near-crash. Your back hurts, but otherwise you feel okay. The ship looks in a rough shape though. All the lights turn off except for a few emergency lights. You should probably get out sooner rather than later.

>undo
The spaceship
[Previous turn undone.]

>undo
The spaceship
[Previous turn undone.]

* * *

>say confirm
(to the computer)

>put on suit
You can't see any such thing.

>put on spacesuit
(first taking the spacesuit)
You put on the spacesuit.

>take off helmet
You aren't wearing the helmet.

>take off spacesuit
You take off the spacesuit.

>say suit up
(to the computer)
The spaceship's machinery puts a space suit on you faster than you could possibly have done it yourself.

>suit up
That's not a verb I recognise.

>launch
That's not a verb I recognise.

>press launch
The computer counts down: "3... 2... 1... LAUNCHING". 

 The world around you starts to disappear into the smoke emmitted from the rocket engine. You feel yourself pressed into the seat as the spaceship lifts off toward the sky. 

The computer says "This ship is equipped with an auto spacesuit. Simply say SUIT UP and the ship will automatically put your space suit on you so you can go out into space."

* * *

>say yes
(to the computer)
That was a rhetorical question.

>say "yes"
(to yourself)
There is no reply.

>showme
Launch Pad - room
    spaceship - closed container
        yourself - person
        ON button
        LAUNCH button

>actions
Actions listing on.

>say yes
(to yourself)
[answering yourself that "yes"]
There is no reply.
[answering yourself that "yes" - succeeded]

* * *

>showme
air - room
    spaceship - closed container
        yourself - person
        ON button
        LAUNCH button
        computer - person
        spacesuit
        helmet

>showme space ship
There seems to be no such object anywhere in the model world.

>showme spaceship
spaceship - closed container
    yourself - person
    ON button
    LAUNCH button
    computer - person
    spacesuit
    helmet
location: in the air
singular-named, improper-named; unlit, inedible, portable; enterable, opaque, closed, openable, unlocked; on, low on fuel
list grouping key: none
printed name: "spaceship"
printed plural name: "containers"
indefinite article: none
description: "A very small rocket. Just big enough to carry one person to space."
initial appearance: none
carrying capacity: 100

>wait
Time passes.

The computer announces: "Auto pilot has engaged. Say CANCEL to fly the ship yourself. Auto pilot has detected that the fuel level is low and will land the ship momentarily."

>say cancel
(to the computer)
The autopilot is disabled.

>restart
Are you sure you want to restart?

>y
Unsafe
An Interactive Fiction by Brian Chen and Jakob Weisblat
Release 1 / Serial number 190222 / Inform 7 build 6M62 (I6/v6.33 lib 6/12N) SD

Bedroom
It's your bedroom. It's not very interesting. The hall is to the east. The side door leads out of the house to the West. You're lying in your bed, just having woken up.

On the nightstand is an iPod.

You can also see the Side Door here.

>test fly
(Testing.)

>[1] open door
You open the Side Door.

>[2] w

The Garden
You can see the Side Door and the Shed (closed) here.

>[3] w

Outskirts of Town
There's less town here than elsewhere. The garden is east. The space center is north. The road is west.

>[4] n

Space Center

>[5] n

Launch Pad
You can see a spaceship (closed) here.

>[6] open spaceship
You open the spaceship, revealing an ON button, a LAUNCH button, a spacesuit and a helmet.

>[7] get in spaceship
You get into the spaceship.

In the spaceship you can see an ON button, a LAUNCH button, a spacesuit and a helmet.

>[8] close spaceship
You close the spaceship.

>[9] press on
You press the ON button. All around you dials spin and lights blink.

A dialog appears on the screen: WARNING: LOW FUEL. SAY "confirm" to continue. Mission abort HIGHLY recommended.

>[10] say confirm
(to the computer)
The dialog on the screen goes away. The screen now reads READY FOR LAUNCH.

>[11] press launch
The computer counts down: "3... 2... 1... LAUNCHING". 

 The world around you starts to disappear into the smoke emmitted from the rocket engine. You feel yourself pressed into the seat as the spaceship lifts off toward the sky. 

The computer says "This ship is equipped with an auto spacesuit. Simply say SUIT UP and the ship will automatically put your space suit on you so you can go out into space."

>say cancel
(to the computer)
The autopilot is disabled.

The computer announces: "Auto pilot has engaged. Say CANCEL to fly the ship yourself. Auto pilot has detected that the fuel level is low and will land the ship momentarily."

>wait
Time passes.

>wait
Time passes.

With a putter then a WHOOSH, the ship runs out of fuel. You don't have much choice but to grip the controls and try to fly it like a plane.

>wait
Time passes.

AAAAAAAAAAAAAAAAAAAAAAAAAAAAAAAAAAAAAAAAAAAAAAAAAAAAAAAAAAAAAAAAAAAAAAAAAAAAAAAAAAAAAAA!
The ship barrels toward the ground at an alarming rate.

>wait
Time passes.

AAAAAAAAAAAAAAAAAAAAAAAAAAAAAAAAAAAAAAAAAAAAAAAAAAAAAAAAAAAAAAAAAAAAAAAAAAAAAAAAAAAAAAA!
The ship barrels toward the ground at an alarming rate.

>wait
Time passes.

AAAAAAAAAAAAAAAAAAAAAAAAAAAAAAAAAAAAAAAAAAAAAAAAAAAAAAAAAAAAAAAAAAAAAAAAAAAAAAAAAAAAAAA!
The ship barrels toward the ground at an alarming rate.

With a CRASH and a BOOM the ship crash lands into the ground. It breaks through the ground and as you die on impact you vaguely recognize your surroundings: this was formerly part of the tunnel of extraction.

You've reached one of this game's 14 endings! In that game you used 21 moves. The optimal number of moves is 21.
Great job, you got the optimal number of moves!

    *** You have died ***

Would you like to RESTART, RESTORE a saved game, QUIT or UNDO the last command?

>wait
Please give one of the answers above.

Would you like to RESTART, RESTORE a saved game, QUIT or UNDO the last command?

* * *

>undo
The spaceship
[Previous turn undone.]

* * *

>wait
Time passes.

AAAAAAAAAAAAAAAAAAAAAAAAAAAAAAAAAAAAAAAAAAAAAAAAAAAAAAAAAAAAAAAAAAAAAAAAAAAAAAAA!
The ship barrels toward the ground at an alarming rate.

>wait
Time passes.

AAAAAAAAAAAAAAAAAAAAAAAAAAAAAAAAAAAAAAAAAAAAAAAAAAAAAAAAAAAAAAAAAAAAAAAAAAAAAAAA!
The ship barrels toward the ground at an alarming rate.

>wait
Time passes.

AAAAAAAAAAAAAAAAAAAAAAAAAAAAAAAAAAAAAAAAAAAAAAAAAAAAAAAAAAAAAAAAAAAAAAAAAAAAAAAA!
The ship barrels toward the ground at an alarming rate.

With a CRASH and a BOOM the ship crash lands into the ground. It breaks through the ground and as you die on impact you vaguely recognize your surroundings: this was formerly part of the tunnel of extraction.

You've reached one of this game's 14 endings! In that game you used 21 moves. The optimal number of moves is 21.
Great job, you got the optimal number of moves!

    *** You have died ***

Would you like to RESTART, RESTORE a saved game, QUIT or UNDO the last command?

* * *

>undo
Mad Scientist's house
[Previous turn undone.]

>wait
Time passes.

>wait
Time passes.

The tube of super glue appears to have dried enough glue to glue itself back together.

>eat glue
That doesn't look very edible right now. Maybe if you could actually squeeze it into your mouth?

>cut glue
You use the sacrificial knife to cut the super glue's tip right off. Glue gurgles out of the tube viscously.

>eat glue
You squeeze the tube of super glue into your mouth. It tastes like candy! Shortly thereafter, it starts to taste like your throat is glued shut. Maybe this wasn't a great idea...
You've reached one of this game's 14 endings! In that game you used 24 moves. The optimal number of moves is 19.
You can reach this ending more quickly!

    *** You have died ***

Would you like to RESTART, RESTORE a saved game, QUIT or UNDO the last command?

* * *

I beg your pardon?

>n
You go into the hunting grounds, foolishly forgetting that there is a moose head atop your own. The hunters waste no time before shooting you.. at least you got a quick death.
You've reached one of this game's 14 endings! In that game you used 35 moves. The optimal number of moves is 36.
Uh-oh, the puzzle is broken! Send us an email!

    *** You have died ***

Would you like to RESTART, RESTORE a saved game, QUIT or UNDO the last command?

>undo
Hunting Lodge
[Previous turn undone.]

* * *

>n
Wow, you nearly fell over. Walking while wearing a taxidermied moose head is hard. Maybe try that again?

>n
You go into the hunting grounds, foolishly forgetting that there is a moose head atop your own. The hunters waste no time before shooting you.. at least you got a quick death.
You've reached one of this game's 14 endings! In that game you used 36 moves. The optimal number of moves is 36.
Great job, you got the optimal number of moves!

    *** You have died ***

Would you like to RESTART, RESTORE a saved game, QUIT or UNDO the last command?

* * *

>n
Wow, you nearly fell over. Walking while wearing a taxidermied moose head is hard. Maybe try that again?

>undo
Hunting Lodge
[Previous turn undone.]

>showme
Hunting Lodge - room
    hunting lodge entrance - open door
    yourself - person
        moose head (worn)
    deer head
    lion head

* * *

>put quarters in coin slot
You can't see any such thing.

* * *

>undo
Hunting Lodge
[Previous turn undone.]

>undo
Hunting Lodge
[Previous turn undone.]

>[34] wear moose head
(first taking the moose head)
You put on the moose head.

>undo
Hunting Lodge
[Previous turn undone.]

>n
Hunting Grounds
Where hunters hunt things, as long as it's the right season. The woods are to the north. You can head into the Hunting Lodge to the south.

You can see the hunting lodge entrance here.

>undo
Hunting Lodge
[Previous turn undone.]

>undo
Hunting Grounds
[Previous turn undone.]

>[33] get moose head
You can't see any such thing.

>[34] wear moose head
You can't see any such thing.

>restart
Are you sure you want to restart?

* * *

>w
Please give one of the answers above.

Would you like to RESTART, RESTORE a saved game, QUIT or UNDO the last command?

>s
Please give one of the answers above.

Would you like to RESTART, RESTORE a saved game, QUIT or UNDO the last command?

>open entrance
Please give one of the answers above.

Would you like to RESTART, RESTORE a saved game, QUIT or UNDO the last command?

>s
Please give one of the answers above.

Would you like to RESTART, RESTORE a saved game, QUIT or UNDO the last command?

>get moose head
Please give one of the answers above.

Would you like to RESTART, RESTORE a saved game, QUIT or UNDO the last command?

>wear moose head
Please give one of the answers above.

Would you like to RESTART, RESTORE a saved game, QUIT or UNDO the last command?

>n
Please give one of the answers above.

Would you like to RESTART, RESTORE a saved game, QUIT or UNDO the last command?

>restart
Unsafe
An Interactive Fiction by Brian Chen and Jakob Weisblat
Release 1 / Serial number 190221 / Inform 7 build 6M62 (I6/v6.33 lib 6/12N) SD

Bedroom
It's your bedroom. It's not very interesting. The hall is to the east. The side door leads out of the house to the West. You're lying in your bed, just having woken up.

On the nightstand is an iPod.

You can also see the Side Door here.

* * *

>eat pie
First you need to take the pie out of the safe.

>undo
Mad Science Laboratory
[Previous turn undone.]

>open inner safe
That's already open.

>undo
Mad Science Laboratory
[Previous turn undone.]

>get pie
Taken.

>eat pie
You eat the pie. It tastes... strange. As though it's been sitting out for 2 weeks. Your stomach starts to feel unpleasant and then --You've reached one of this game's 14 endings! In that game you used 32 moves. The optimal number of moves is 32.
Great job, you got the optimal number of moves!

    *** You have died ***

Would you like to RESTART, RESTORE a saved game, QUIT or UNDO the last command?

* * *

>x time safe
A locker labelled "TIME SAFE - place objects in here to guarantee that they age properly while not being messed with by people wandering by or the wind while you are in the time machine.

>open time safe
You open the time safe, revealing a middle safe.

>open middle safe
You open the middle safe, revealing an inner safe.

>open inner safe
You open the inner safe.

>put pie in time safe
There's no room. You have to put it in the innermost safe.

>put pie in inner safe
You put the pie into the inner safe.

>close inner safe
You close the inner safe.

>close middle safe
You close the middle safe.

>close time safe
You close the time safe.

>enter time machine
You get into the time machine.

In the time machine you can see a red button and a coin slot (closed).

>put quarter in slot
You put a quarter in the slot. It makes a satisfying *clink*.

>press button
You feel yourself pressed back into the seat, and the world swirls around you. The sun sets and rises again many times. And then, suddenly, the world is calm.

>get out
You get out of the time machine.

Mad Science Laboratory
You can see a ladder, a time machine (in which are a red button and a coin slot (closed)) and a time safe (closed) here.

>open time safe
You open the time safe, revealing a middle safe.

* * *

>open middle safe
You open the middle safe, revealing an inner safe.

>open inner safe
You open the inner safe, revealing a pie.

>showme ipe
There seems to be no such object anywhere in the model world.

>showme pie
pie - thing
location: in the inner safe in the middle safe in the time safe in the Mad Science Laboratory
singular-named, improper-named; unlit, edible, portable, handled, tub-relevant; aged
list grouping key: none
printed name: "pie"
printed plural name: none
indefinite article: none
description: "A meat pie that looks like it came out of the oven just this morning."
initial appearance: none

* * *

>pour bucket
Please give one of the answers above.

Would you like to RESTART, RESTORE a saved game, QUIT or UNDO the last command?

>x tub
Please give one of the answers above.

Would you like to RESTART, RESTORE a saved game, QUIT or UNDO the last command?

>x swimming
Please give one of the answers above.

Would you like to RESTART, RESTORE a saved game, QUIT or UNDO the last command?

>x swimming piranhas
Please give one of the answers above.

Would you like to RESTART, RESTORE a saved game, QUIT or UNDO the last command?

>x tub
Please give one of the answers above.

Would you like to RESTART, RESTORE a saved game, QUIT or UNDO the last command?

>showme swimming
Please give one of the answers above.

Would you like to RESTART, RESTORE a saved game, QUIT or UNDO the last command?

>get water
Please give one of the answers above.

Would you like to RESTART, RESTORE a saved game, QUIT or UNDO the last command?

>dip bucket in tub
Please give one of the answers above.

Would you like to RESTART, RESTORE a saved game, QUIT or UNDO the last command?

>get in tub
Please give one of the answers above.

Would you like to RESTART, RESTORE a saved game, QUIT or UNDO the last command?

* * *

>x tub
It's a bathtub. Big enough to sit in comfortably or lie down in uncomfortably. 

The drain is plugged. The faucet is on. The water is around 10% of the way up the edge of the tub.

>i
You are carrying:
  a bucket
    a bucketful of piranha-infested water

>dump bucket in tub
I only understood you as far as wanting to dump the bucket.

>dump bucket
You dump the water and the piranhas into the tub. The water, and the piranhas with it, flow out the drain.

* * *

>x tub
It's a bathtub. Big enough to sit in comfortably or lie down in uncomfortably. 

The drain is plugged. The faucet is on. The water is around 10% of the way up the edge of the tub.

>x tub
It's a bathtub. Big enough to sit in comfortably or lie down in uncomfortably. 

The drain is plugged. The faucet is on. The water is around 20% of the way up the edge of the tub.

>x tub
It's a bathtub. Big enough to sit in comfortably or lie down in uncomfortably. 

The drain is plugged. The faucet is on. The water is around 30% of the way up the edge of the tub.

>showme tub
bathtub - thing
    drain (part of bathtub)
    faucet (part of bathtub)
location: in the Bathroom
singular-named, improper-named; unlit, inedible, fixed in place
list grouping key: none
printed name: "bathtub"
printed plural name: none
indefinite article: none
description: "It's a bathtub. Big enough to sit in comfortably or lie down in uncomfortably. 

The drain is plugged. The faucet is off. The water is around 00% of the way up the edge of the tub.
"
initial appearance: none
its water level: 0

>showme faucet
faucet - thing
location: part of the bathtub in the Bathroom
singular-named, improper-named; unlit, inedible, portable; off
list grouping key: none
printed name: "faucet"
printed plural name: none
indefinite article: none
description: none
initial appearance: none

>turn on faucet
You turn on the faucet. Water starts flowing out.

>x faucet
You see nothing special about the faucet.

>x faucet
You see nothing special about the faucet.

>showme faucet
faucet - thing
location: part of the bathtub in the Bathroom
singular-named, improper-named; unlit, inedible, portable; off
list grouping key: none
printed name: "faucet"
printed plural name: none
indefinite article: none
description: none
initial appearance: none

* * *

>x tub
It's a bathtub. Big enough to sit in comfortably or lie down in uncomfortably. 

The drain is plugged. The faucet is on. The water is around 30% of the way up the edge of the tub.

>x tub
It's a bathtub. Big enough to sit in comfortably or lie down in uncomfortably. 

The drain is plugged. The faucet is on. The water is around 40% of the way up the edge of the tub.

>x tub
It's a bathtub. Big enough to sit in comfortably or lie down in uncomfortably. 

The drain is plugged. The faucet is on. The water is around 50% of the way up the edge of the tub.

>x tub
It's a bathtub. Big enough to sit in comfortably or lie down in uncomfortably. 

The drain is plugged. The faucet is on. The water is around 60% of the way up the edge of the tub.

>x tub
It's a bathtub. Big enough to sit in comfortably or lie down in uncomfortably. 

The drain is plugged. The faucet is on. The water is around 70% of the way up the edge of the tub.

>x tub
It's a bathtub. Big enough to sit in comfortably or lie down in uncomfortably. 

The drain is plugged. The faucet is on. The water is around 80% of the way up the edge of the tub.

>x tub
It's a bathtub. Big enough to sit in comfortably or lie down in uncomfortably. 

The drain is plugged. The faucet is on. The water is around 90% of the way up the edge of the tub.

>x tub
It's a bathtub. Big enough to sit in comfortably or lie down in uncomfortably. 

The drain is plugged. The faucet is on. The water is around 100% of the way up the edge of the tub.
 the bathtub is overflowing into the bathroom. For some reason, you don't really care about this.

The tub overflows and a fair amount of water flows out of the bathtub into the rest of the bathroom.

>x tub
It's a bathtub. Big enough to sit in comfortably or lie down in uncomfortably. 

The drain is plugged. The faucet is on. The water is around 100% of the way up the edge of the tub.
 the bathtub is overflowing into the bathroom. For some reason, you don't really care about this.

The tub overflows and a fair amount of water flows out of the bathtub into the rest of the bathroom.

>turn off faucet
You turn off the faucet. Water stops flowing.

The tub overflows and a fair amount of water flows out of the bathtub into the rest of the bathroom.

>wait
Time passes.

>x tub
It's a bathtub. Big enough to sit in comfortably or lie down in uncomfortably. 

The drain is plugged. The faucet is off. The water is around 90% of the way up the edge of the tub.

>pour bucket
You dump the water and the piranhas into the tub. The piranhas swim around in the bathwater.

The tub overflows and a fair amount of water flows out of the bathtub into the rest of the bathroom.

>x tub
It's a bathtub. Big enough to sit in comfortably or lie down in uncomfortably. 

The drain is plugged. The faucet is off. The water is around 90% of the way up the edge of the tub.

>showme piranhas
swimming piranhas - thing
location: the bathtub in the Bathroom
singular-named, improper-named; unlit, inedible, portable
list grouping key: none
printed name: "swimming piranhas"
printed plural name: none
indefinite article: none
description: none
initial appearance: none

* * *

>undo
Abandoned Train Station
[Previous turn undone.]

>undo
Abandoned Train Station
[Previous turn undone.]

>[37] get on edge
You get onto the edge of the platform.

>undo
Abandoned Train Station
[Previous turn undone.]

>undo
Abandoned Train Station
[Previous turn undone.]

>[36] put earbuds in ipod
You plug the earbuds into the iPod. Your favorite song starts to play through them!

>[37] get on edge
You get onto the edge of the platform.

>undo
Abandoned Train Station
[Previous turn undone.]

>undo
Control Room
[Previous turn undone.]

>[35] put on earbuds
You put on earbuds.

>[36] put earbuds in ipod
You plug the earbuds into the iPod. Your favorite song starts to play through them!

>[37] get on edge
You can't see any such thing.

>undo
Control Room
[Previous turn undone.]

>x button
(the CALL TRAIN button)
A big red button labelled CALL TRAIN. Next to the button is a handwritten note reading "This button doesn't work very well. Sometimes you have to press it ten or twenty times to get it to work.".

>l button
(the CALL TRAIN button)
A big red button labelled CALL TRAIN. Next to the button is a handwritten note reading "This button doesn't work very well. Sometimes you have to press it ten or twenty times to get it to work.".

>l
Control Room
Where things get controlled.

You can see the CALL TRAIN button here.

>run
You'll have to say which compass direction to go in.

>run east
You can't go that way.

The iPod has stopped playing its song. Maybe it ran out of battery.

>run west
Abandoned Train Station
No trains.

* * *

I beg your pardon?

>take off shoes
(work shoes)
You take off work shoes.

>w
That doesn't look like a safe place to go without shoes.

>put on work shoes
You put on work shoes.

>w
Abandoned Warehouse
The warehouse is old and abandoned. It is big and extends south. Not much more to say. The Road is to the North. The Tunnel of Extraction is below. There are holes in the wall to the East and West.

You can see The Tunnel of Extraction here.

* * *

>run across the tracks
Please give one of the answers above.

Would you like to RESTART, RESTORE a saved game, QUIT or UNDO the last command?

* * *

>take off shoes
(shoes)
You take off shoes.

>i
You are carrying:
  a pair of running shoes
  pants (being worn)
  underwear (being worn)
  socks (being worn)
  a shirt (being worn)
  shoes
  a belt (being worn)
  a hat (being worn)
  a jacket (being worn)

>l
Basement
The dark basement of your house. The hall is upstairs. The Tunnel of Extraction is to the west.

You can see The Tunnel of Extraction, a vat (closed) and a key cabinet (in which is a small metal key) here.

>w
That doesn't look like a safe place to go without shoes.

>put on running shoes
You put on the pair of running shoes.

>w
You're wearing running shoes. These are for running, not just exploring.

* * *

>put on shoes
Which do you mean, the pair of running shoes or shoes?

>put on the shoes
Which do you mean, the pair of running shoes or shoes?

* * *

>open spaceship
You open the spaceship, revealing an ON button, a LAUNCH button, a spacesuit and a helmet.

>put fuel in spaceship
You can't see any such thing.

* * *

>put fuel in ship
You pour the rocket fuel into the ship, closing the hatch when you are done.

>get in ship
You get into the spaceship.

In the spaceship you can see an ON button, a LAUNCH button, a spacesuit and a helmet.

>press on
You press the ON button. All around you dials spin and lights blink.

>press launch
Launching with the door open seems like an extraordinarily bad idea, even for yourself.

>undo
Launch Pad
[Previous turn undone.]

>close door
You close the spaceship.

* * *

>press launch
The computer counts down: "3... 2... 1... LAUNCHING". 

 The world around you starts to disappear into the smoke emmitted from the rocket engine. You feel yourself pressed into the seat as the spaceship lifts off toward the sky. 

The computer says "This ship is equipped with an auto spacesuit. Simply say SUIT UP and the ship will automatically put your space suit on you so you can go out into space."

>say suit up
(to the computer)
The spaceship's machinery puts a space suit on you faster than you could possibly have done it yourself.

The spaceship has reached space. It's full of stars! It's the most beautiful thing you've ever seen! Now what?

>open door
You open the spaceship.

>go out
You would have to get out of the spaceship first.

>undo
outer space
[Previous turn undone.]

>get out
You get out of the spaceship.

outer space
You can see a spaceship (in which are an ON button and a LAUNCH button) here.

>take off helmet
You take off the helmet.

* * *

>put fuel in ship
You pour the rocket fuel into the ship, closing the hatch when you are done.

>undo
Launch Pad
[Previous turn undone.]

>i
You are carrying:
  a bucket
    a bucketful of rocket fuel

* * *

>take off helmet
You see space, with your own eyes. It's stunningly beautiful. Then your head explodes.
You've reached one of this game's 14 endings! In that game you used 29 moves. The optimal number of moves is 29.
Great job, you got the optimal number of moves!

    *** You have died ***

Would you like to RESTART, RESTORE a saved game, QUIT or UNDO the last command?

* * *

>put quarters in slot
quarter: You put a quarter in the slot. It makes a satisfying *clink*.
quarter: You can only insert one coin per turn.
quarter: You can only insert one coin per turn.

>put quarters in slot
quarter: You put a quarter in the slot. It makes a satisfying *clink*.
quarter: You can only insert one coin per turn.

* * *

>climb ash
In the Ash Tree

* * *

>climb ash tree
Lower Branches of Ash Tree
You're a bit off the ground in the ash tree.

>up
Upper Branches of Ash Tree
More tree.

>up
You can't go that way.

* * *

>climb elm
Bedroom
It's your bedroom. It's not very interesting. The hall is to the east. The side door leads out of the house to the West. 

On the nightstand is an iPod.

You can also see the Side Door here.

>showme elm
elm tree - tree
location: in the Woods
singular-named, improper-named; unlit, inedible, portable
list grouping key: none
printed name: "elm tree"
printed plural name: "trees"
indefinite article: none
description: none
initial appearance: none
branches: Bedroom
at the top of it: Bedroom
its height: 0
its player position: 0

>climb up elm
You can't see any such thing.

>climb down
You must name something more substantial.

* * *

Unsafe
An Interactive Fiction by Brian Chen and Jakob Weisblat
Release 1 / Serial number 190223 / Inform 7 build 6M62 (I6/v6.33 lib 6/12N) SD

Bedroom
It's your bedroom. It's not very interesting. The hall is to the east. The side door (closed) leads out of the house to the West. You're lying in your bed, just having woken up.

On the nightstand is an iPod.

>w
You can't go through the Side Door because it's closed.

* * *

>e
Hall
The hall in the middle of your house. Your bedroom is to the West. The staircase leading upwards is to the North. The back entryway is to the South. The kitchen is to the East. There is a muddy brown key hanging from a hook on the wall. You can also go down to the basement from here.

You can see a Staircase and a muddy brown key here.

>d
Basement
The dark basement of your house. The hall is upstairs. The Tunnel of Extraction is to the west.

You can see The Tunnel of Extraction, a vat (closed) and a key cabinet (closed) here.

>open vat
You lift the large plastic lid off of the vat, revealing the pungent rocket fuel beneath.

>x vat
A large vat holding a greenish liquid. Who knows how long it's been here?

In the vat is rocket fuel.

>close vat
You close the vat.

>open vat
You lift the large plastic lid off of the vat, revealing the pungent rocket fuel beneath.

>u
Hall
The hall in the middle of your house. Your bedroom is to the West. The staircase leading upwards is to the North. The back entryway is to the South. The kitchen is to the East. There is a muddy brown key hanging from a hook on the wall. You can also go down to the basement from here.

You can see a Staircase and a muddy brown key here.

>w
Bedroom
It's your bedroom. It's not very interesting. The hall is to the east. The side door leads out of the house to the West.

On the nightstand is an iPod.

You can also see the Side Door here.

>open door
You open the Side Door.

* * *

>w
The Garden
You can see the Side Door and the Shed (closed) here.

>e
Bedroom
It's your bedroom. It's not very interesting. The hall is to the east. The side door leads out of the house to the West.

On the nightstand is an iPod.

You can also see the Side Door here.

>e
Hall
The hall in the middle of your house. Your bedroom is to the West. The staircase leading upwards is to the North. The back entryway is to the South. The kitchen is to the East. There is a muddy brown key hanging from a hook on the wall. You can also go down to the basement from here.

You can see a Staircase and a muddy brown key here.

* * *

>w
Hall
The hall in the middle of your house. Your bedroom is to the West. The staircase leading upwards is to the North. The back entryway is to the South. The kitchen is to the East. There is a muddy brown key hanging from a hook on the wall. You can also go down to the basement from here.

You can see a Staircase and a muddy brown key here.

>w
Bedroom
It's your bedroom. It's not very interesting. The hall is to the east. The side door leads out of the house to the West.

On the nightstand is an iPod.

You can also see the Side Door here.

>w
The Garden
You can see the Side Door and the Shed (closed) here.

* * *

>w
(first getting off the stool)

Outskirts of Town
There's less town here than elsewhere. The garden is east. The space center is north. The road is west.

>e
The Garden
You can see a stool, the Side Door and the Shed (closed) here.

>e
Bedroom
It's your bedroom. It's not very interesting. The hall is to the east. The side door leads out of the house to the West.

On the nightstand is an iPod.

You can also see the Side Door here.

>d
You can't go that way.

>e
Hall
The hall in the middle of your house. Your bedroom is to the West. The staircase leading upwards is to the North. The back entryway is to the South. The kitchen is to the East. There is a muddy brown key hanging from a hook on the wall. You can also go down to the basement from here.

You can see a Staircase and a muddy brown key here.

>d
Basement
The dark basement of your house. The hall is upstairs. The Tunnel of Extraction is to the west.

You can see The Tunnel of Extraction, a vat (in which is rocket fuel) and a key cabinet (closed) here.

>get rocket fuel
Taken.

>open cabinet
You open the key cabinet, revealing a small metal key.

>get key
(the key cabinet)
(the small metal key)
Taken.

>u
Hall
The hall in the middle of your house. Your bedroom is to the West. The staircase leading upwards is to the North. The back entryway is to the South. The kitchen is to the East. There is a muddy brown key hanging from a hook on the wall. You can also go down to the basement from here.

You can see a Staircase and a muddy brown key here.

* * *

>w
Bedroom
It's your bedroom. It's not very interesting. The hall is to the east. The side door leads out of the house to the West.

On the nightstand is an iPod.

You can also see the Side Door here.

>w
The Garden
You can see the Side Door, a stool and the Shed (closed) here.

>get cage
You can't see any such thing.

>open shed
(the Shed)
It seems to be locked.

>w
Outskirts of Town
There's less town here than elsewhere. The garden is east. The space center is north. The road is west.

>e
The Garden
You can see the Side Door, a stool and the Shed (closed) here.

>e
Bedroom
It's your bedroom. It's not very interesting. The hall is to the east. The side door leads out of the house to the West.

On the nightstand is an iPod.

You can also see the Side Door here.

* * *

>e
Hall
The hall in the middle of your house. Your bedroom is to the West. The staircase leading upwards is to the North. The back entryway is to the South. The kitchen is to the East. There is a muddy brown key hanging from a hook on the wall. You can also go down to the basement from here.

You can see a Staircase and a muddy brown key here.

>get key
(the muddy brown key)
Taken.

>w
Bedroom
It's your bedroom. It's not very interesting. The hall is to the east. The side door leads out of the house to the West.

On the nightstand is an iPod.

You can also see the Side Door here.

* * *

>w
The Garden
You can see the Side Door, a stool and the Shed (closed) here.

>unlock shed
What do you want to unlock the Shed with?

>unlock shed with brown key
(the Shed with the muddy brown key)
You unlock the Shed.

>open shed
(the Shed)
You open the Shed, revealing a cage.

* * *

>get cage
Taken.

>x cage
A white metal cage that looks to have held a pet rabbit long ago.

>w
Outskirts of Town
There's less town here than elsewhere. The garden is east. The space center is north. The road is west.

>e
The Garden
You can see the Side Door, a stool and the Shed (empty) here.

>e
Bedroom
It's your bedroom. It's not very interesting. The hall is to the east. The side door leads out of the house to the West.

On the nightstand is an iPod.

You can also see the Side Door here.

>e
Hall
The hall in the middle of your house. Your bedroom is to the West. The staircase leading upwards is to the North. The back entryway is to the South. The kitchen is to the East. You can also go down to the basement from here.

You can see a Staircase here.

>e
Kitchen
You can see a toaster, a cabinet (closed) and a refrigerator (closed) here.

>w
Hall
The hall in the middle of your house. Your bedroom is to the West. The staircase leading upwards is to the North. The back entryway is to the South. The kitchen is to the East. You can also go down to the basement from here.

You can see a Staircase here.

>d
Basement
The dark basement of your house. The hall is upstairs. The Tunnel of Extraction is to the west.

You can see The Tunnel of Extraction, a vat (empty) and a key cabinet (empty) here.

>w
Abandoned Warehouse
The warehouse is old and abandoned. It is big and extends south. Not much more to say. The Road is to the North. The Tunnel of Extraction is below. There are holes in the wall to the East and West.

You can see The Tunnel of Extraction here.

>s
A Spooky Lair
A lair in which a demonic ritual might be held. There is a table with a pentagram drawn on it.

On the table are a candle and a sacrificial knife.

You can also see a snake named Alice, a snake named Bob, a snake named Charlie, a snake named David and an ancient cabinet (closed) here.

>place cage down
That's not a verb I recognise.

>put cage down
Dropped.

>open cabinet
You open the ancient cabinet, revealing three jars.

>l
A Spooky Lair
A lair in which a demonic ritual might be held. There is a table with a pentagram drawn on it.

On the table are a candle and a sacrificial knife.

You can also see a cage (empty), a snake named Alice, a snake named Bob, a snake named Charlie, a snake named David and an ancient cabinet (in which are three jars (closed)) here.

>open ancient cabinet
That's already open.

>open cabinet
That's already open.

>open old cabinet
You can't see any such thing.

>close key cabinet
You can't see any such thing.

>close drawer
You can't see any such thing.

>open drawer
You can't see any such thing.

>l
A Spooky Lair
A lair in which a demonic ritual might be held. There is a table with a pentagram drawn on it.

On the table are a candle and a sacrificial knife.

You can also see a cage (empty), a snake named Alice, a snake named Bob, a snake named Charlie, a snake named David and an ancient cabinet (in which are three jars (closed)) here.

>x key cabinet
You can't see any such thing.

>i
You are carrying:
  a muddy brown key
  a small metal key
  rocket fuel
  a bucket

>n
Abandoned Warehouse
The warehouse is old and abandoned. It is big and extends south. Not much more to say. The Road is to the North. The Tunnel of Extraction is below. There are holes in the wall to the East and West.

You can see The Tunnel of Extraction here.

>d
Basement
The dark basement of your house. The hall is upstairs. The Tunnel of Extraction is to the west.

You can see The Tunnel of Extraction, a vat (empty) and a key cabinet (empty) here.

>get key
(the key cabinet)
(the small metal key)
You already have that.

>get metal key
You already have that.

>w
Abandoned Warehouse
The warehouse is old and abandoned. It is big and extends south. Not much more to say. The Road is to the North. The Tunnel of Extraction is below. There are holes in the wall to the East and West.

You can see The Tunnel of Extraction here.

>s
A Spooky Lair
A lair in which a demonic ritual might be held. There is a table with a pentagram drawn on it.

On the table are a candle and a sacrificial knife.

You can also see a cage (empty), a snake named Alice, a snake named Bob, a snake named Charlie, a snake named David and an ancient cabinet (in which are three jars (closed)) here.

>l
A Spooky Lair
A lair in which a demonic ritual might be held. There is a table with a pentagram drawn on it.

On the table are a candle and a sacrificial knife.

You can also see a cage (empty), a snake named Alice, a snake named Bob, a snake named Charlie, a snake named David and an ancient cabinet (in which are three jars (closed)) here.

>x cage
A white metal cage that looks to have held a pet rabbit long ago.

>close cage
You close the cage.

>x cage
A white metal cage that looks to have held a pet rabbit long ago.

>l
A Spooky Lair
A lair in which a demonic ritual might be held. There is a table with a pentagram drawn on it.

On the table are a candle and a sacrificial knife.

You can also see a cage (closed and empty), a snake named Alice, a snake named Bob, a snake named Charlie, a snake named David and an ancient cabinet (in which are three jars (closed)) here.

>open cage
You open the cage.

>close cabinet
You close the ancient cabinet.

>open cabinet
You open the ancient cabinet, revealing three jars.

* * *

>open jar
You open the jar, revealing a mouse.

>x jar
In the jar is a mouse.

>take mouse
Taken.

>put mouse in cage
A rattlesnake rushes into the cage and hungrily slurps up the mouse before it even has time to get its bearings.

>wait
Time passes.

>wait
Time passes.

The snake slithers out of the cage with remarkable speed.

>wait
Time passes.

>undo
A Spooky Lair
[Previous turn undone.]

>close cage
You close the cage.

>lock cage
What do you want to lock the cage with?

>lock cage with key
Which do you mean, the muddy brown key or the small metal key?

>lock cage with small key
You lock the cage.

Angry at being locked up and not wanting to be a pet, the snake breaks through the cage and attaches itself to your eye. You feeel the effects of the venom almost immediately.
You've reached one of this game's 14 endings! In that game you used 83 moves. The optimal number of moves is 22.
You can reach this ending more quickly!

    *** You have died ***

Would you like to RESTART, RESTORE a saved game, QUIT or UNDO the last command?

>restart
You wake up in your bedroom.

Unsafe
An Interactive Fiction by Brian Chen and Jakob Weisblat
Release 1 / Serial number 190221 / Inform 7 build 6M62 (I6/v6.33 lib 6/12N) SD

Bedroom
It's your bedroom. It's not very interesting. The hall is to the east. The side door leads out of the house to the West.

On the nightstand is an iPod.

You can also see the Side Door here.

* * *

>w
The Garden
You can see the Side Door and the Shed (closed) here.

>l shed
(the Shed)
A narrow rusty shed. The shed is really tall and you can't see above it.

>e
Bedroom
It's your bedroom. It's not very interesting. The hall is to the east.

You can see the Side Door here.

* * *

>e
Kitchen
You can see a toaster, a cabinet (closed), a refrigerator (closed) and a stool here.

>take stool
Taken.

>w
Hall
The hall in the middle of your house. Your bedroom is to the West. The staircase leading upwards is to the North. The back entryway is to the South. (??) The kitchen is to the East.

You can see a Staircase here.

* * *

>w
Bedroom
It's your bedroom. It's not very interesting. The hall is to the east.

You can see the Side Door here.

>w
The Garden
You can see the Side Door and the Shed (closed) here.

>drop stool
Dropped.

* * *

>x shed
(the Shed)
A narrow rusty shed. On the shed's roof, you can see a bucket.

>take bucket
Taken.

>l
The Garden (on the stool)
You can see the Side Door and the Shed (closed) here.

>x shed
(the Shed)
A narrow rusty shed. On the shed's roof, you can see nothing.

>get off
You get off the stool.

The Garden
You can see a stool, the Side Door and the Shed (closed) here.

>x shed
(the Shed)
A narrow rusty shed. The shed is really tall and you can't see above it.

>i
You are carrying:
  a bucket

>w
Outskirts of Town
There's less town here than elsewhere. The garden is east. The space center is north. The road is west.

>w
Road
It's a road, like what people travel on. The outskirts of town are to the east. To the North you can see a fork in the road.

>w
Stream

>take water
You can't see any such thing.

* * *

Unsafe
An Interactive Fiction by Brian Chen and Jakob Weisblat
Release 1 / Serial number 190223 / Inform 7 build 6M62 (I6/v6.33 lib 6/12N) SD

Bedroom
It's your bedroom. It's not very interesting. The hall is to the east. The side door (closed) leads out of the house to the West. You're lying in your bed, just having woken up.

On the nightstand is an iPod.

>x me
You're wearing pants, underwear, socks, a shirt, shoes, a belt, a hat and a jacket.

>take off belt
You take off the belt.

>take off hat
You take off the hat.

* * *

>take off shirt
You take off the shirt.

>take off socks
You need to take your shoes off first!

>undo
Bedroom
[Previous turn undone.]

>take off shoes
You take off shoes.

>take off socks
You take off socks.

>take off pants
You take off pants.

>x me
You're wearing underwear.

>take off underwear
You take off underwear.

>x me
You're wearing nothing.