You wake up in your bedroom.

Unsafe
An Interactive Fiction by Brian Chen and Jakob Weisblat
Release 1 / Serial number 190221 / Inform 7 build 6M62 (I6/v6.33 lib 6/12N) SD

Bedroom
It's your bedroom. It's not very interesting. The hall is to the east.

You can see the Side Door here.

>e
Hall
The hall in the middle of your house. Your bedroom is to the West. The staircase leading upwards is to the North. The back entryway is to the South. (??) The kitchen is to the East.

You can see a Staircase here.

* * *

>get stool
Taken.

>w
Hall
The hall in the middle of your house. Your bedroom is to the west. The staircase leading upwards is to the north. (??) The kitchen is to the east.

You can see a Staircase here.

>n
Upstairs Hall
The second floor of your house. Stairs lead down. The study is west, and the bathroom is east.

You can see a Staircase here.

* * *

>e
Bathroom
You can see a medicine cabinet (closed) here.

>put stool down
Dropped.

* * *

>open cabinet
You open the medicine cabinet, revealing hair gel.

>get gel
Taken.

>put on gel
You put on hair gel.

>w
(first getting off the stool)

Upstairs Hall
The second floor of your house. Stairs lead down. The study is west, and the bathroom is east.

You can see a Staircase here.

* * *

>d
Hall
The hall in the middle of your house. Your bedroom is to the west. The staircase leading upwards is to the north. (??) The kitchen is to the east.

You can see a Staircase here.

>d
Basement
The dark basement of your house. The hall is upstairs. The Tunnel of Extraction is to the west.

You can see The Tunnel of Extraction here.

* * *

>w
Abandoned Warehouse
The warehouse is old and abandoned.It is big and extends south. Not much more to say. The Road is to the North. The Tunnel of Extraction is below. There are holes in the wall to the East and West.

You can see The Tunnel of Extraction here.

>s
A Spooky Lair
A lair in which a demonic ritual might be held. There is a table with a pentagram drawn on it.

On the table is a candle.

You can also see four snakes here.

>get candle
You touch the candle. The flame leaps onto your hair. Boom!
You've reached one of this game's 14 endings! In that game you used 17 moves. The optimal number of moves is 17.
Great job, you got the optimal number of moves!

    *** You have died ***

Would you like to RESTART, RESTORE a saved game, QUIT or UNDO the last command?

* * *

>e
Kitchen
You can see a toaster, a cabinet (closed), a refrigerator (closed) and a stool here.

>open fridge
You can't see any such thing.

>open refrigerator
You open the refrigerator, revealing a fish.

>get fish
Taken.

>w
Hall
The hall in the middle of your house. Your bedroom is to the West. The staircase leading upwards is to the North. The back entryway is to the South. (??) The kitchen is to the East.

You can see a Staircase here.

* * *

>s
You can't go through the back door because it's closed.

>s
You can't go through the back door because it's closed.

>u
You can't go that way.

>undo
Back Entryway
[Previous turn undone.]

>undo
Back Entryway
[Previous turn undone.]

>undo
Hall
[Previous turn undone.]

>s
Back Entryway
The back entryway to your house. It's a tiny room with a coat rack and a trash can being the most notable scenery. The hall is to the North, the backyard to the South.

You can see the back door and a blue key here.

>get key
Taken.

>unlock door
What do you want to unlock the back door with?

>unlock door
What do you want to unlock the back door with?

>unlock door with key
You unlock the back door.

>s
You can't go through the back door because it's closed.

>undo
Back Entryway
[Previous turn undone.]

>open door
You open the back door.

>s
Backyard
You can see the back door and a stick here.

>get stick
Taken.

>n
Back Entryway
The back entryway to your house. It's a tiny room with a coat rack and a trash can being the most notable scenery. The hall is to the North, the backyard to the South.

You can see the back door here.

>n
Hall
The hall in the middle of your house. Your bedroom is to the West. The staircase leading upwards is to the North. The back entryway is to the South. (??) The kitchen is to the East.

You can see a Staircase here.

>d
Basement
The dark basement of your house. The hall is upstairs. The Tunnel of Extraction is to the west.

You can see The Tunnel of Extraction here.

* * *

>w
clearing

>w
Edge of the woods

>w
As you walk into the woods, a large grizzly bear shows up, baring (bear-ing?) its teeth at you. You hastily take three steps back.
The bear seems to be guarding the entrance to the woods. Seems like it would be awfully difficult to get through here unless the bear were somehow distracted. With food, maybe?

>drop fish
You throw the fish to the west. The bear looks at the fish curiously.

>wait
Time passes.

The bear finally decides to eat the fish, in a big gulp.

>wait
Time passes.

The bear rubs its belly sleepily. Maybe it'll fall asleep soon.

>wait
Time passes.

The bear flops onto its full stomach and starts snoring.

>w
Woods
You can see a grizzly bear here.

>attack bear
You take your stick and poke the bear. It wakes up and promptly eats you.
You've reached one of this game's 14 endings! In that game you used 24 moves. The optimal number of moves is 24.
Great job, you got the optimal number of moves!

    *** You have died ***

Would you like to RESTART, RESTORE a saved game, QUIT or UNDO the last command?

* * *

>e
Hall
The hall in the middle of your house. Your bedroom is to the West. The staircase leading upwards is to the North. The back entryway is to the South. (??) The kitchen is to the East.

You can see a Staircase here.

>s
Back Entryway
The back entryway to your house. It's a tiny room with a coat rack and a trash can being the most notable scenery. The hall is to the North, the backyard to the South.

You can see the back door and a blue key here.

>go through back door
You can't go through the back door because it's closed.

>get blue key
Taken.

>unlock back door
(with the blue key)
You unlock the back door.

>undo
Back Entryway
[Previous turn undone.]

>get key
Taken.

>unlock door
(with the blue key)
You unlock the back door.

>open door
You open the back door.

>s
backyard
You can see a back door and a stick here.

>get stick
Taken.

>n
Back Entryway
The back entryway to your house. It's a tiny room with a coat rack and a trash can being the most notable scenery. The hall is to the North, the backyard to the South.

You can see a back door here.

>n
Hall
The hall in the middle of your house. Your bedroom is to the West. The staircase leading upwards is to the North. The back entryway is to the South. (??) The kitchen is to the East.

You can see a Staircase here.

>e
Kitchen
You can see a toaster, a cabinet (closed), a refrigerator (closed) and a stool here.

>open refrigerator
You open the refrigerator, revealing a fish.

* * *

>w
clearing

>w
edge of the woods

>w
Woods

* * *

>s
Back Entryway
The back entryway to your house. It's a tiny room with a coat rack and a trash can being the most notable scenery. The hall is to the North, the backyard to the South.

You can see the back door and a blue key here.

>take key
Taken.

>unlock door
(with the blue key)
You unlock the back door.

>s
You can't go through the back door because it's closed.

* * *

>s
Backyard
You can see the back door and a stick here.

>take stick
Taken.

>n
Back Entryway
The back entryway to your house. It's a tiny room with a coat rack and a trash can being the most notable scenery. The hall is to the North, the backyard to the South.

You can see the back door here.

* * *

>open fridge
You can't see any such thing.

>undo
Kitchen
[Previous turn undone.]

>open fridge
You can't see any such thing.

>l
Kitchen
You can see a toaster, a cabinet (closed), a refrigerator (closed) and a stool here.

>undo
Kitchen
[Previous turn undone.]

>open refrigerator
You open the refrigerator, revealing a fish.

>take fish
Taken.

>n
You can't go that way.

>undo
Kitchen
[Previous turn undone.]

>w
Hall
The hall in the middle of your house. Your bedroom is to the West. The staircase leading upwards is to the North. The back entryway is to the South. (??) The kitchen is to the East.

You can see a Staircase here.

* * *

>w
As you walk into the woods, a large grizzly bear shows up, baring (bear-ing?) its teeth at you. You hastily take three steps back.
The bear seems to be guarding the entrance to the woods. Seems like it would be awfully difficult to get through here unless the bear were somehow distracted. With food, maybe?

>throw fish
You throw the fish to the west. The bear looks at the fish curiously.

>z
Time passes.

The bear finally decides to eat the fish, in a big gulp.

>z
Time passes.

The bear rubs its belly sleepily. Maybe it'll fall asleep soon.

>z
Time passes.

The bear flops onto its full stomach and starts snoring.

>w
Woods
You can see a grizzly bear here.

>undo
Edge of the woods
[Previous turn undone.]

>w
Woods
You can see a grizzly bear here.

>poke bear
That's not a verb I recognise.

>attack bear
You take your stick and poke the bear. It wakes up and promptly eats you.
You've reached one of this game's 14 endings! In that game you used 24 moves. The optimal number of moves is 24.
Great job, you got the optimal number of moves!

    *** You have died ***

Would you like to RESTART, RESTORE a saved game, QUIT or UNDO the last command?

* * *

You wake up in your bedroom.

Unsafe
An Interactive Fiction by Brian Chen and Jakob Weisblat
Release 1 / Serial number 190221 / Inform 7 build 6M62 (I6/v6.33 lib 6/12N) SD

Bedroom
It's your bedroom. It's not very interesting. The hall is to the east.

You can see the Side Door here.

>l
Bedroom
It's your bedroom. It's not very interesting. The hall is to the east.

You can see the Side Door here.

>e
Hall
The hall in the middle of your house. Your bedroom is to the West. The staircase leading upwards is to the North. The back entryway is to the South. (??) The kitchen is to the East.

You can see a Staircase here.

* * *

>take fish
Taken.

>x fish
You see nothing special about the fish.

>throw fish w
I only understood you as far as wanting to throw the fish.

* * *

You wake up in your bedroom.

Unsafe
An Interactive Fiction by Brian Chen and Jakob Weisblat
Release 1 / Serial number 190221 / Inform 7 build 6M62 (I6/v6.33 lib 6/12N) SD

Bedroom
It's your bedroom. It's not very interesting. The hall is to the east.

You can see the Side Door here.

>w
You can't go through the Side Door because it's closed.

>s
You can't go that way.

>e
Hall
The hall in the middle of your house. Your bedroom is to the West. The staircase leading upwards is to the North. The back entryway is to the South. (??) The kitchen is to the East.

You can see a Staircase here.

* * *

>open fridge
You can't see any such thing.

>open refrigerator
You open the refrigerator, revealing a fish and a pie.

>get pie
Taken.

>x pie
You see nothing special about the pie.

>x fish
You see nothing special about the fish.

>l pie
You see nothing special about the pie.

>l fish
You see nothing special about the fish.

>x fridge
You can't see any such thing.