You wake up in your bedroom.

Unsafe
An Interactive Fiction by Brian Chen and Jakob Weisblat
Release 1 / Serial number 190220 / Inform 7 build 6M62 (I6/v6.33 lib 6/12N) SD

Bedroom
It's your bedroom. It's not very interesting. The hall is to the east.

You can see the Side Door here.

>e
Hall
The hall in the middle of your house. Your bedroom is to the west. The staircase leading upwards is to the north. (??) The kitchen is to the east.

You can see a Staircase here.

>e
Kitchen
You can see a toaster, a cabinet (closed), a refrigerator (closed) and a stool here.

* * *

>take stool
Taken.

>w
Hall
The hall in the middle of your house. Your bedroom is to the west. The staircase leading upwards is to the north. (??) The kitchen is to the east.

You can see a Staircase here.

>u
Upstairs Hall
The second floor of your house. Stairs lead down. The study is west, and the bathroom is east.

You can see a Staircase here.

>e
Bathroom
You can see a medicine cabinet (closed) here.

>drop stool
Dropped.

* * *

>get on stool
You get onto the stool.

>open cabinet
You open the medicine cabinet, revealing hair gel.

>take hair gel
Taken.

>wear gel
You put on hair gel.

>w
(first getting off the stool)

Upstairs Hall
The second floor of your house. Stairs lead down. The study is west, and the bathroom is east.

You can see a Staircase here.

>d
Hall
The hall in the middle of your house. Your bedroom is to the west. The staircase leading upwards is to the north. (??) The kitchen is to the east.

You can see a Staircase here.

>d
Basement
The dark basement of your house. The hall is upstairs. The Tunnel of Extraction is to the west.

You can see a Tunnel of Extraction here.

>w
Abandoned Warehouse
The warehouse is old and abandoned. Not much more to say. The Road is to the west. There's something to the south. The Tunnel of Extraction is below.

You can see a Tunnel of Extraction here.

>s
A Spooky Lair
A lair in which a demonic ritual might be held. There is a table with a pentagram drawn on it.

On the table is a candle.

You can also see four snakes here.

>take candle
You touch the candle. The flame leaps onto your hair. Boom!
You've reached one of this game's 14 endings! In that game you used 17 moves. The optimal number of moves is 17.
Great job, you got the optimal number of moves!

    *** You have died ***

Would you like to RESTART, RESTORE a saved game, QUIT or UNDO the last command?

* * *

>take stool
Taken.

>x stool
It's a stool that you can stand on.

>get on stool
You can only get into something free-standing.

>drop stool
Dropped.

>stand on stool
You get onto the stool.

>l
Kitchen (on the stool)
You can see a toaster, a cabinet (closed) and a refrigerator (closed) here.

>take stool
You would have to get off the stool first.

>off
That's not a verb I recognise.

>down
(first getting off the stool)
You can't go that way.

>w
Hall
The hall in the middle of your house. Your bedroom is to the west. The staircase leading upwards is to the north. (??) The kitchen is to the east.

You can see a Staircase here.

>e
Kitchen
You can see a stool, a toaster, a cabinet (closed) and a refrigerator (closed) here.

>take stool
Taken.

* * *

>w
Hall
The hall in the middle of your house. Your bedroom is to the west. The staircase leading upwards is to the north. (??) The kitchen is to the east.

You can see a Staircase here.

>w
Bedroom
It's your bedroom. It's not very interesting. The hall is to the east.

You can see the Side Door here.

>w
You can't go through the Side Door because it's closed.

* * *

>w
The Garden
You can see the Side Door and the Shed (closed) here.

>x shed
(the Shed)
You see nothing special about the Shed.

>open shed
(the Shed)
It seems to be locked.

>l
The Garden
You can see the Side Door and the Shed (closed) here.

>take bucket
Taken.

>stand on stool
You can only get into something free-standing.

>drop stool
Dropped.

>restart
Are you sure you want to restart?

>yes
You wake up in your bedroom.

Unsafe
An Interactive Fiction by Brian Chen and Jakob Weisblat
Release 1 / Serial number 190220 / Inform 7 build 6M62 (I6/v6.33 lib 6/12N) SD

Bedroom
It's your bedroom. It's not very interesting. The hall is to the east.

You can see the Side Door here.

>e
Hall
The hall in the middle of your house. Your bedroom is to the west. The staircase leading upwards is to the north. (??) The kitchen is to the east.

You can see a Staircase here.

* * *

>w
Hall
The hall in the middle of your house. Your bedroom is to the west. The staircase leading upwards is to the north. (??) The kitchen is to the east.

You can see a Staircase here.

>u
Upstairs Hall
The second floor of your house. Stairs lead down. The study is west.

You can see a Staircase here.

>e
Bathroom
You can see a medicine cabinet (closed) here.

>open cabinet
You open the medicine cabinet, revealing hair gel.

* * *

>take hair gel
Taken.

>use gel
That's not a verb I recognise.

>spray gel
That's not a verb I recognise.

>x gel
You see nothing special about hair gel.

>put gel on
You put on hair gel.

>w
Upstairs Hall
The second floor of your house. Stairs lead down. The study is west.

You can see a Staircase here.

>d
Hall
The hall in the middle of your house. Your bedroom is to the west. The staircase leading upwards is to the north. (??) The kitchen is to the east.

You can see a Staircase here.

>d
basement

>w
You can't go that way.

* * *

>n
You can't go that way.

>e
You can't go that way.

* * *

>s
You can't go that way.

>l
basement

* * *

>e
Kitchen
You can see a toaster, a cabinet (closed), a refrigerator (closed) and a stool here.

>take toaster
Taken.

>take cabinet
Taken.

>take refrigerator
Taken.

* * *

>e
Kitchen
You can see a toaster, a cabinet (closed), a refrigerator (closed) and a stool here.

>x toaster
The toaster is currently switched off.

>switch on toaster
You switch the toaster on.

>x toaster
The toaster is currently switched on.

>x cabinet
You see nothing special about the cabinet.

>open cabinet
You open the cabinet, revealing a top drawer, a middle drawer and a bottom drawer.

* * *

>e
Hall
The hall in the middle of your house. Your bedroom is to the west. The staircase leading upwards is to the north. (??) The kitchen is to the east.

You can see a Staircase here.

>go up
Upstairs hall
You can see a Staircase here.

>go down
Hall
You can see a Staircase here.

>go to stairs
You can't see any such thing.

>x staircase
You see nothing special about the Staircase.

>w
Bedroom

>e
Hall
You can see a Staircase here.

>n
Upstairs hall
You can see a Staircase here.

>s
You can't go that way.

>n
You can't go that way.

>w
Study

>n
Closet

>e
You can't go that way.

>s
Study

>e
Upstairs hall
You can see a Staircase here.

* * *

>e
Hall
The hall in the middle of your house. Your bedroom is to the west. The staircase leading upwards is to the north. (??) The kitchen is to the east.

You can see a Staircase here.

>n
Upstairs Hall
The second floor of your house. Stairs lead down. The study is west, and the bathroom is east.

You can see a Staircase here.

>e
Bathroom
You can see a medicine cabinet (closed) here.

>open cabinet
You're not tall enough to reach the medicine cabinet. Drat!

>w
Upstairs Hall
The second floor of your house. Stairs lead down. The study is west, and the bathroom is east.

You can see a Staircase here.

>d
Hall
The hall in the middle of your house. Your bedroom is to the west. The staircase leading upwards is to the north. (??) The kitchen is to the east.

You can see a Staircase here.

>e
Kitchen
You can see a toaster, a cabinet (closed), a refrigerator (closed) and a stool here.

* * *

>stand on stool
You get onto the stool.

>open cabinet
You open the medicine cabinet, revealing hair gel.

>take gel
Taken.

>w
(first getting off the stool)

Upstairs Hall
The second floor of your house. Stairs lead down. The study is west, and the bathroom is east.

You can see a Staircase here.

* * *

>d
Hall
The hall in the middle of your house. Your bedroom is to the west. The staircase leading upwards is to the north. (??) The kitchen is to the east.

You can see a Staircase here.

>put gel on
You put on hair gel.

>d
Basement
The dark basement of your house. The hall is upstairs. The Tunnel of Extraction is to the west.

You can see a Tunnel of Extraction here.

* * *

>s
A Spooky Lair
A lair in which a demonic ritual might be held. There is a table with a pentagram drawn on it.

On the table is a candle.

You can also see four snakes here.

>take candle
You touch the candle. The flame leaps onto your hair. Boom!
You've reached one of this game's 14 endings! In that game you used 22 moves. The optimal number of moves is 17.
You can reach this ending more quickly!

    *** You have died ***

Would you like to RESTART, RESTORE a saved game, QUIT or UNDO the last command?

* * *

>e
Hall
The hall in the middle of your house. Your bedroom is to the west. The staircase leading upwards is to the north. (??) The kitchen is to the east.

You can see a Staircase here.

>u
Upstairs Hall
The second floor of your house. Stairs lead down. The study is west, and the bathroom is east.

You can see a Staircase here.

* * *

You wake up in your bedroom.

Unsafe
An Interactive Fiction by Brian Chen and Jakob Weisblat
Release 1 / Serial number 190220 / Inform 7 build 6M62 (I6/v6.33 lib 6/12N) SD

Bedroom
It's your bedroom. It's not very interesting. The hall is to the east.

You can see the Side Door here.

>go to hall
You can't see any such thing.

>e
Hall
You can see a Staircase here.

>e
Kitchen

* * *

You wake up in your bedroom.

Unsafe
An Interactive Fiction by Brian Chen and Jakob Weisblat
Release 1 / Serial number 190220 / Inform 7 build 6M62 (I6/v6.33 lib 6/12N) SD

Bedroom
It's your bedroom. It's not very interesting. The hall is to the east.

You can see the Side Door here.

>s
You can't go that way.

>w
(first opening the Side Door)

The Garden
You can see the Side Door and the Shed (closed) here.

>get bucket
Taken.

>l
The Garden
You can see the Side Door and the Shed (closed) here.

>x shed
(the Shed)
You see nothing special about the Shed.

>put bucket on shed
(the Shed)
Putting things on the Shed would achieve nothing.

>put bucket on roof
You put the bucket on the Roof of the Shed.

>w
Outskirts of Town
To the North you can see a fork in the road.

>w
Road

* * *

You wake up in your bedroom.

Unsafe
An Interactive Fiction by Brian Chen and Jakob Weisblat
Release 1 / Serial number 190220 / Inform 7 build 6M62 (I6/v6.33 lib 6/12N) SD

Bedroom
It's your bedroom. It's not very interesting. The hall is to the east.

You can see the Side Door here.

>verbose
Unsafe is now in its "verbose" mode, which always gives long descriptions of locations (even if you've been there before).

>showrules
That's not a verb I recognise.

>show rules
You can't see any such thing.

>show
(yourself the Side Door)
(first taking the Side Door)
That's fixed in place.

>rules
Rules tracing now switched on. Type "rules off" to switch it off again, or "rules all" to include even rules which do not apply.

* * *

You wake up in your bedroom.

Unsafe
An Interactive Fiction by Brian Chen and Jakob Weisblat
Release 1 / Serial number 190220 / Inform 7 build 6M62 (I6/v6.33 lib 6/12N) SD

Bedroom
It's your bedroom. It's not very interesting. The hall is to the east.

You can see the Side Door here.

>w
You can't go through the Side Door because it's closed.

* * *

>undo
Bedroom
[Previous turn undone.]

>undo
Bedroom
[Previous turn undone.]

* * *

You wake up in your bedroom.

Unsafe
An Interactive Fiction by Brian Chen and Jakob Weisblat
Release 1 / Serial number 190220 / Inform 7 build 6M62 (I6/v6.33 lib 6/12N) SD

Bedroom
It's your bedroom. It's not very interesting. The hall is to the east.

You can see the Side Door here.

>x
What do you want to examine?

>l
Bedroom

>w
You can't go that way.

>e
Hall

>n
You can't go that way.

>u
Upstairs Hall

>d
Hall

>e
Kitchen

>nw
You can't go that way.

>ne
You can't go that way.

>s
You can't go that way.

* * *

>e
You can't go that way.

>w
Hall

>s
Back Entryway

>ne
You can't go that way.