Welcome to Unsafe. If you're not sure what to do, type "help".

Bedroom
It's your bedroom. It's not very interesting. The hall is to the East. The side door (closed) leads out of the house to the West. 

You've just gotten out of your bed, having woken up from a nap.

On the nightstand is an iPod.

>e
Hall
The hall in the middle of your house. Your bedroom is to the West. The staircase leading upwards is to the North. The back entryway is to the South. The kitchen is to the East. You can also go down to the basement from here.

There is a muddy brown key hanging from a hook on the wall.

>d
Basement
The dark basement of your house. The hall is upstairs. The Tunnel of Extraction is to the West.

You can see The Tunnel of Extraction, a vat (closed) and a key cabinet (in which is a small metal key) here.

>s
You can't go that way.

>open cabinet
That's already open.

>w
You go through the long and winding Tunnel of Extraction.

Abandoned Warehouse
The warehouse is old and abandoned. It is big and extends south. Not much more to say. The Road is to the North. The Tunnel of Extraction is below. There are holes in the wall to the East and West.

You can see The Tunnel of Extraction here.

>s
A Spooky Lair
A lair in which a demonic ritual might be held. There is a table with a pentagram drawn on it.

On the table are a candle and a sacrificial knife.

You can also see four snakes and an ancient cabinet (closed) here.

>open cabinet
You open the ancient cabinet, revealing three jars.

>get jar
Taken.

>open jar
You open the jar, revealing a mouse.

>get mouse
Taken.

>wait
Time passes.

>wait
Time passes.

>n
Abandoned Warehouse
The warehouse is old and abandoned. It is big and extends south. Not much more to say. The Road is to the North. The Tunnel of Extraction is below. There are holes in the wall to the East and West.

You can see The Tunnel of Extraction here.

>n
Road
It's a road, like what people travel on. The outskirts of town are to the east. To the North you can see a fork in the road. The stream is west.

>e
Outskirts of Town
There's less town here than there is to the South. The garden is east. The space center is North. The road is West.

>n
Space Center
Your friendly neighborhood space center. They build rockets and stuff. The outskirts of town are South, the launch pad is North.

>n
Launch Pad
The place where rockets take off from. The rest of the Space Center is South.

You can see a spaceship here.

>n
You can't go that way.

I beg your pardon?

I beg your pardon?

>open ship
You open the spaceship, revealing an ON button, a LAUNCH button, a spacesuit and a helmet.

>get in ship
This space center has a strict no-mice policy. You'll have to put down any mice you are carrying before you get in.

I beg your pardon?

>put down mouse
The mouse sees an opportunity and scurries off before it can be put back in a jar.

>undo
Launch Pad
[Previous turn undone.]

>put mouse in jar
You put the mouse into the jar.

>close jar
You close the jar.

>get in ship
This space center has a strict no-mice policy. You'll have to put down any mice you are carrying before you get in.

>put down jar
Dropped.

* * *

>d
Basement
The dark basement of your house. The hall is upstairs. The Tunnel of Extraction is to the West.

You can see The Tunnel of Extraction, a vat (closed) and a key cabinet (in which is a small metal key) here.

>x liquid
You can't see any such thing.

>open vat
You lift the large plastic lid off of the vat, revealing the pungent rocket fuel beneath.

>x liquid
You see nothing special about rocket fuel.

* * *

>e
Hall
The hall in the middle of your house. Your bedroom is to the West. The staircase leading upwards is to the North. The back entryway is to the South. The kitchen is to the East. You can also go down to the basement from here.

There is a muddy brown key hanging from a hook on the wall.

>e
Kitchen
Where food happens. The hall is to the West.

You can see a toaster, a cabinet (closed), a refrigerator (closed) and a stool here.

>open fridge
You open the refrigerator, revealing a fish and a pie.

>get pie
Taken.

>w
Hall
The hall in the middle of your house. Your bedroom is to the West. The staircase leading upwards is to the North. The back entryway is to the South. The kitchen is to the East. There is a muddy brown key hanging from a hook on the wall. You can also go down to the basement from here.

You can see a Staircase and a muddy brown key here.

>u
Upstairs Hall
The second floor of your house. Stairs lead down. The study is west, and the bathroom is east.

You can see a Staircase and a left running shoe here.

>w
Study
Where you study. The hall is east.

On the desk are a dime and a quarter.

You can also see the closet door here.

>get quarter
Taken.

>e
Upstairs Hall
The second floor of your house. Stairs lead down. The study is west, and the bathroom is east.

You can see a Staircase and a left running shoe here.

>d
Hall
The hall in the middle of your house. Your bedroom is to the West. The staircase leading upwards is to the North. The back entryway is to the South. The kitchen is to the East. There is a muddy brown key hanging from a hook on the wall. You can also go down to the basement from here.

You can see a Staircase and a muddy brown key here.

>d
Basement
The dark basement of your house. The hall is upstairs. The Tunnel of Extraction is to the west.

You can see The Tunnel of Extraction, a vat (closed) and a key cabinet (in which is a small metal key) here.

>w
You go through the long and winding Tunnel of Extraction.

Abandoned Warehouse
The warehouse is old and abandoned. It is big and extends south. Not much more to say. The Road is to the North. The Tunnel of Extraction is below. There are holes in the wall to the East and West.

You can see The Tunnel of Extraction here.

>e
Town Square
The Town Square stretches out in front of you. There are 10 or 20 unremarkable buildings that you couldn't care less about. South of you is the Mad Scientist's House. West, a hole in the wall leads into the Abandoned Warehouse. North of here, the town thins out.

You can see the Mad Scientist's Grand Entrance here.

>open entrance
You open the Mad Scientist's Grand Entrance.

>s
Mad Scientist's House
A house filled with so many useless gadgets the like of which you've never seen. There are tubes, filling two thirds of the room. High up on the wall there is a shelf. Taking up one entire wall of the room is an enormous amplifier.

On the high-up shelf are a small tool box (closed) and a bottle of soylent.

You can also see the Mad Scientist's Grand Entrance and a ladder here.

>use ladder
Mad Science Laboratory
A room full of so much mad science, it makes you mad just to think about it. The wall is covered in chalkboards, and the chalkboards are covered in diagrams, and the diagrams are covered in labels. Maddening.

You can see a ladder, a time machine and a time safe (closed) here.

>drop pie
Dropped.

>get in machine
You get into the time machine.

In the time machine you can see a red button and a coin slot (closed).

>put quarter in slot
You put a quarter in the slot. It makes a satisfying *clink*.

>pres button
That's not a verb I recognise.

>press button
You feel yourself pressed back into the seat, and the world swirls around you. The sun sets and rises again many times. And then, suddenly, the world is calm.

>w
You would have to get out of the time machine first.

>get out
You get out of the time machine.

Mad Science Laboratory
A room full of so much mad science, it makes you mad just to think about it. The wall is covered in chalkboards, and the chalkboards are covered in diagrams, and the diagrams are covered in labels. Maddening.

You can see pie crumbs, a ladder, a time machine and a time safe (closed) here.

>d
Mad Scientist's House
A house filled with so many useless gadgets the like of which you've never seen. There are tubes, filling two thirds of the room. High up on the wall there is a shelf. Taking up one entire wall of the room is an enormous amplifier.

On the high-up shelf are a small tool box (closed) and a bottle of soylent.

You can also see a ladder and the Mad Scientist's Grand Entrance here.

>d
You can't go that way.

>e
You can't go that way.

>s
You can't go that way.

>n
Town Square
The Town Square stretches out in front of you. There are 10 or 20 unremarkable buildings that you couldn't care less about. South of you is the Mad Scientist's House. West, a hole in the wall leads into the Abandoned Warehouse. North of here, the town thins out.

You can see the Mad Scientist's Grand Entrance here.

>w
Abandoned Warehouse
The warehouse is old and abandoned. It is big and extends south. Not much more to say. The Road is to the North. The Tunnel of Extraction is below. There are holes in the wall to the East and West.

You can see The Tunnel of Extraction here.

>w
Clearing
It's very clear here. The edge of the woods is to the west. A hole that leads into the abandoned warehouse is to the east. There's a stream to the north.

>w
Edge of the Woods
The woods start here and extend to the west. There's a clearing to the east.

>w
Woods
There's lots of trees, in particular, an ash tree, an elm tree, and a pine tree. The edge of the woods is to the east. Going south, you can see signs for a hunting lodge. You can hear a faint sound from above.

>e
Edge of the Woods
The woods start here and extend to the west. There's a clearing to the east.

>e
Clearing
It's very clear here. The edge of the woods is to the west. A hole that leads into the abandoned warehouse is to the east. There's a stream to the north.

>e
Abandoned Warehouse
The warehouse is old and abandoned. It is big and extends south. Not much more to say. The Road is to the North. The Tunnel of Extraction is below. There are holes in the wall to the East and West.

You can see The Tunnel of Extraction here.

>e
Town Square
The Town Square stretches out in front of you. There are 10 or 20 unremarkable buildings that you couldn't care less about. South of you is the Mad Scientist's House. West, a hole in the wall leads into the Abandoned Warehouse. North of here, the town thins out.

You can see the Mad Scientist's Grand Entrance here.

>e
You can't go that way.

>e
You can't go that way.

>n
Outskirts of Town
There's less town here than there is to the South. The garden is east. The space center is North. The road is West.

>e
The Garden
A small garden. There are a few different kinds of flowers and a few different kinds of squash. It's a peaceful place. A spigot on the wall sits above a circular indent in the dirt.

You can see the shed (closed) here.

>e
You can't go through the Side Door because it's closed.

>e
You can't go through the Side Door because it's closed.

>open door
You open the Side Door.

>e
Bedroom
It's your bedroom. It's not very interesting. The hall is to the east. The side door (open) leads out of the house to the West. 

On the nightstand is an iPod.

>e
Hall
The hall in the middle of your house. Your bedroom is to the West. The staircase leading upwards is to the North. The back entryway is to the South. The kitchen is to the East. There is a muddy brown key hanging from a hook on the wall. You can also go down to the basement from here.

You can see a Staircase and a muddy brown key here.

>e
Kitchen
You can see a toaster, a cabinet (closed), a refrigerator (in which is a fish) and a stool here.

>get stool
Taken.

>w
Hall
The hall in the middle of your house. Your bedroom is to the West. The staircase leading upwards is to the North. The back entryway is to the South. The kitchen is to the East. There is a muddy brown key hanging from a hook on the wall. You can also go down to the basement from here.

You can see a Staircase and a muddy brown key here.

>w
Bedroom
It's your bedroom. It's not very interesting. The hall is to the east. The side door (open) leads out of the house to the West. 

On the nightstand is an iPod.

>w
The Garden
A small garden. There are a few different kinds of flowers and a few different kinds of squash. It's a peaceful place. A spigot on the wall sits above a circular indent in the dirt.

You can see the shed (closed) here.

>w
Outskirts of Town
There's less town here than there is to the South. The garden is east. The space center is North. The road is West.

>w
Road
It's a road, like what people travel on. The outskirts of town are to the east. To the North you can see a fork in the road. The stream is west.

>w
By the Stream
There's a stream, making whatever sound water makes. There's also a scary warning sign.

>w
You can't go that way.

>s
Clearing
It's very clear here. The edge of the woods is to the west. A hole that leads into the abandoned warehouse is to the east. There's a stream to the north.

>w
Edge of the Woods
The woods start here and extend to the west. There's a clearing to the east.

>geuse stool
That's not a verb I recognise.

>use stool
Dropped.

Now you might want to get on the stool.

>use stool
You get onto the stool.

>climb ash
You can't see any such thing.

>l
Edge of the Woods (on the stool)
The woods start here and extend to the west. There's a clearing to the east.

>get off stool
You get off the stool.

Edge of the Woods
The woods start here and extend to the west. There's a clearing to the east.

You can see a stool here.

>get stool
Taken.

>w
Woods
There's lots of trees, in particular, an ash tree, an elm tree, and a pine tree. The edge of the woods is to the east. Going south, you can see signs for a hunting lodge. You can hear a faint sound from above.

>put down stool
Dropped.

>get on stool
You get onto the stool.

>climb ash
Lower Branches of Ash Tree
You're a bit off the ground in the ash tree.

* * *

>e
Kitchen
Where food happens. The hall is to the West.

You can see a toaster, a cabinet (closed), a refrigerator (closed) and a stool here.

>take all
stool: Taken.

>open toaster
It isn't something you can open.

>open cabinet
You open the cabinet, revealing a top drawer, a middle drawer and a bottom drawer.

>search cabinet
In the cabinet are a top drawer, a middle drawer and a bottom drawer.

>x top
You see nothing special about the top drawer.

>open top
You open the top drawer, revealing cereal crumbs.

>x crumbs
You see nothing special about cereal crumbs.

>take crumbs
Those probably aren't worth your time.

>take middle
That's fixed in place.

>open middle
You open the middle drawer, revealing a big tupperware container.

>take tupperware
It seems to be stuck to the drawer with honey or something. Probably best just to leave it there.

>open bottom
It's stuck. But you're pretty sure it's empty; you don't recall ever having used it.

>l
Kitchen
Where food happens. The hall is to the West.

You can see a toaster, a cabinet (in which are a top drawer (in which is cereal crumbs), a middle drawer (in which is a big tupperware container (closed)) and a bottom drawer (closed)) and a refrigerator (closed) here.

>open tupperware
You open the big tupperware container, revealing a loaf of bread.

>x brea
You can't see any such thing.

>x bread
A loaf of bread, whole grain and fresh from the bakery. It's pre-sliced! It's tightly wrapped in plastic.

>take bread
Taken.

>l
Kitchen
Where food happens. The hall is to the West.

You can see a toaster, a cabinet (in which are a top drawer (in which is cereal crumbs), a middle drawer (in which is a big tupperware container (empty)) and a bottom drawer (closed)) and a refrigerator (closed) here.

>open fridge
You open the refrigerator, revealing a fish and a pie.

>l
Kitchen
Where food happens. The hall is to the West.

You can see a toaster, a cabinet (in which are a top drawer (in which is cereal crumbs), a middle drawer (in which is a big tupperware container (empty)) and a bottom drawer (closed)) and a refrigerator (in which are a fish and a pie) here.

>take all
cereal crumbs: One thing at a time!
fish: One thing at a time!
pie: One thing at a time!

>x fish
It's a blue herring. Delicious!

>take fish
Taken.

>x pie
A meat pie that looks like it came out of the oven just this morning.

>take pie
Taken.

>x pie
A meat pie that looks like it came out of the oven just this morning.

>eat pie
You eat the pie. Not bad.

>undo
Kitchen
[Previous turn undone.]

* * *

>e
Kitchen
Where food happens. The hall is to the West.

You can see a toaster, a cabinet (closed), a refrigerator (closed) and a stool here.

>take stool
Taken.

>w
Hall
The hall in the middle of your house. Your bedroom is to the West. The staircase leading upwards is to the North. The back entryway is to the South. The kitchen is to the East. You can also go down to the basement from here.

There is a muddy brown key hanging from a hook on the wall.

>w
Bedroom
It's your bedroom. It's not very interesting. The hall is to the East. The side door (closed) leads out of the house to the West. 

On the nightstand is an iPod.

>open door
You open the Side Door.

>w
The Garden
A small garden. There are a few different kinds of flowers and a few different kinds of squash. It's a peaceful place. A spigot on the wall sits above a circular indent in the dirt. You could swear there used to be a bucket somewhere around here, but you don't see it anywhere...

The side door to your house is East, and a path leads off towards town to the West.

You can see the shed (closed) here.

>drop stool
Dropped.

>get on stool
You get onto the stool.

>take bucket
Taken.

>e
(first getting off the stool)

Bedroom
It's your bedroom. It's not very interesting. The hall is to the East. The side door (open) leads out of the house to the West. 

On the nightstand is an iPod.

>e
Hall
The hall in the middle of your house. Your bedroom is to the West. The staircase leading upwards is to the North. The back entryway is to the South. The kitchen is to the East. You can also go down to the basement from here.

There is a muddy brown key hanging from a hook on the wall.

* * *

>d
Basement
The dark basement of your house. The hall is upstairs. The Tunnel of Extraction is to the West.

You can see The Tunnel of Extraction, a vat (closed) and a key cabinet (in which is a small metal key) here.

>open vat
You lift the large plastic lid off of the vat, revealing the pungent rocket fuel beneath.

>fill bucket
What do you want to fill the bucket in?

>fuel
You dip the bucket in the vat of rocket fuel and come out with a fair amount. This stuff is lighter than it looks!

>undo
Basement
[Previous turn undone.]

>vat
You dip the bucket in the vat of rocket fuel and come out with a fair amount. This stuff is lighter than it looks!

>undo
Basement
[Previous turn undone.]

>undo
Basement
[Previous turn undone.]

>l
Basement
The dark basement of your house. The hall is upstairs. The Tunnel of Extraction is to the West.

You can see The Tunnel of Extraction, a vat (in which is rocket fuel) and a key cabinet (in which is a small metal key) here.

>fill bucket in fuel
You dip the bucket in the vat of rocket fuel and come out with a fair amount. This stuff is lighter than it looks!

>undo
Basement
[Previous turn undone.]

>ndo
That's not a verb I recognise.

>undo
Basement
[Previous turn undone.]

>undo
Hall
[Previous turn undone.]

>d
Basement
The dark basement of your house. The hall is upstairs. The Tunnel of Extraction is to the West.

You can see The Tunnel of Extraction, a vat (closed) and a key cabinet (in which is a small metal key) here.

* * *

>fuel
You dip the bucket in the vat of rocket fuel and come out with a fair amount. This stuff is lighter than it looks!

>fill bucket with fuel
Try DIPping the bucket in something.

>undo
Basement
[Previous turn undone.]

>fill bucket in fue
You can't see any such thing.

>undo
Basement
[Previous turn undone.]

>fill bucket in fuel
Which do you mean, rocket fuel or the bucketful of rocket fuel?

>take fuel
Which do you mean, rocket fuel or the bucketful of rocket fuel?

>e
I only understood you as far as wanting to take east.

>e
You can't go that way.

>undo
Basement
[Previous turn undone.]

>w
You go through the long and winding Tunnel of Extraction.

Abandoned Warehouse
The warehouse is old and abandoned. It is big and extends South. Not much more to say. The Road is to the North. The Tunnel of Extraction is below. There are holes in the wall to the East and West.

You can see The Tunnel of Extraction here.

>n
Road
It's a road, like what people travel on. The outskirts of town are to the East. To the North you can see a fork in the road. The stream is West. The warehouse is South.

>e
Outskirts of Town
There's less town here than there is to the South. The garden is East. The space center is North. The road is West.

>n
Space Center
Your friendly neighborhood space center. They build rockets and stuff. The outskirts of town are South, the launch pad is North.

* * *

>n
Launch Pad
The place where rockets take off from. The rest of the Space Center is South.

You can see a spaceship here.

>pour bucket
You pour the rocket fuel into the ship's fuel hatch, closing the hatch when you are done.
As if in a gesture of thanks, the computer opens the door to the spaceship for you.

>e
You can't go that way.

* * *

>e
Kitchen
Where food happens. The hall is to the West.

You can see a toaster, a cabinet (closed), a refrigerator (closed) and a stool here.

>u
You can't go that way.

>w
Hall
The hall in the middle of your house. Your bedroom is to the West. The staircase leading upwards is to the North. The back entryway is to the South. The kitchen is to the East. You can also go down to the basement from here.

There is a muddy brown key hanging from a hook on the wall.

>e
Kitchen
Where food happens. The hall is to the West.

You can see a toaster, a cabinet (closed), a refrigerator (closed) and a stool here.

>w
Hall
The hall in the middle of your house. Your bedroom is to the West. The staircase leading upwards is to the North. The back entryway is to the South. The kitchen is to the East. You can also go down to the basement from here.

There is a muddy brown key hanging from a hook on the wall.

>n
Upstairs Hall
The second floor of your house. Stairs lead down. The study is West, and the bathroom is East.

You can see a left running shoe here.

>u
You can't go that way.

>take shoe
Taken.

>ar shoe
That's not a verb I recognise.

>wear shoe
You can't wear just one running shoe - that would simply be unstylish.

>w
Study
Where you study. The hall is East.

On the desk are a dime and a quarter.

You can also see the closet door here.

>e
Upstairs Hall
The second floor of your house. Stairs lead down. The study is West, and the bathroom is East.

>e
Bathroom
It's just a bathroom. The Upstairs Hall is West.

You can see a mirror, a medicine cabinet (closed) and a bathtub (empty) here.

>w
Upstairs Hall
The second floor of your house. Stairs lead down. The study is West, and the bathroom is East.

>s
You can't go that way.

>s
You can't go that way.

>d
Hall
The hall in the middle of your house. Your bedroom is to the West. The staircase leading upwards is to the North. The back entryway is to the South. The kitchen is to the East. You can also go down to the basement from here.

There is a muddy brown key hanging from a hook on the wall.

>d
Basement
The dark basement of your house. The hall is upstairs. The Tunnel of Extraction is to the West.

You can see The Tunnel of Extraction, a vat (closed) and a key cabinet (in which is a small metal key) here.

>u
Hall
The hall in the middle of your house. Your bedroom is to the West. The staircase leading upwards is to the North. The back entryway is to the South. The kitchen is to the East. You can also go down to the basement from here.

There is a muddy brown key hanging from a hook on the wall.

>u
Upstairs Hall
The second floor of your house. Stairs lead down. The study is West, and the bathroom is East.

>e
Bathroom
It's just a bathroom. The Upstairs Hall is West.

You can see a mirror, a medicine cabinet (closed) and a bathtub (empty) here.

* * *

>w
Upstairs Hall
The second floor of your house. Stairs lead down. The study is West, and the bathroom is East.

>w
Study
Where you study. The hall is East.

On the desk are a dime and a quarter.

You can also see the closet door here.

>x closet
You look into the closet. There's a chest of drawers in there.

>take shoe
You already have that.

>open drawers
You can't see any such thing.

>open chest
You can't see any such thing.

>enter closet
The Closet
A small room. The study is South.

You can see the closet door and a chest of drawers here.

>x chest
It's an old wooden chest with 5 drawers. The bottom drawer is open.

>open drawer
Which do you mean, the first drawer, the second drawer, the third drawer, the fourth drawer or the fifth drawer?

>top
You open the first drawer, revealing a quarter.

>open second
You open the second drawer, revealing a quarter.

>en third
That's not a verb I recognise.

>open fourth
You open the fourth drawer, revealing a quarter.

>take all
chest of drawers: One thing at a time!
quarter: One thing at a time!
quarter: One thing at a time!
quarter: One thing at a time!
quarter: One thing at a time!

>take quarter
Taken.

>take quarter
Taken.

>g
Taken.

>g
Taken.

>take chest
Taken.

>i
You are carrying:
  a chest of drawers
  four quarters
  a left running shoe
  pants (being worn)
  underwear (being worn)
  socks (being worn)
  a shirt (being worn)
  work shoes (being worn)
  a belt (being worn)
  a hat (being worn)
  a jacket (being worn)

>x chest
It's an old wooden chest with 5 drawers. The top drawer is open. The second drawer is open. The fourth drawer is open. The bottom drawer is open.

>w
You can't go that way.

>w
You can't go that way.

>n
You can't go that way.

>s
Study
Where you study. The hall is East.

On the desk are a dime and a quarter.

You can also see the closet door here.

>take dime
Taken.

>take quarter
Taken.

>e
Upstairs Hall
The second floor of your house. Stairs lead down. The study is West, and the bathroom is East.

>d
Hall
The hall in the middle of your house. Your bedroom is to the West. The staircase leading upwards is to the North. The back entryway is to the South. The kitchen is to the East. You can also go down to the basement from here.

There is a muddy brown key hanging from a hook on the wall.

>s
Back Entryway
The back entryway to your house. It's a tiny room with a coat rack and a trash can being the most notable scenery. There is a Toyota key tied to the coat rack. The hall is to the North, the backyard to the South.

You can see the back door, a blue key, a right running shoe and a Toyota key here.

>take shoe
(the right running shoe)
Taken.

>wear shoes
Which do you mean, the pair of running shoes or work shoes?

>running shoes
You should probably take your work shoes off first.

>take work shoes off
You take off work shoes.

>wear running shoes
You put on the pair of running shoes.

>tak erunning shoes off
That's not a verb I recognise.

* * *

>n
Upstairs Hall
The second floor of your house. Stairs lead down. The study is West, and the bathroom is East.

You can see a left running shoe here.

>take running shoe
Taken.

>s
You can't go that way.

* * *

>u
Hall
The hall in the middle of your house. Your bedroom is to the West. The staircase leading upwards is to the North. The back entryway is to the South. The kitchen is to the East. You can also go down to the basement from here.

There is a muddy brown key hanging from a hook on the wall.

>s
Back Entryway
The back entryway to your house. It's a tiny room with a coat rack and a trash can being the most notable scenery. There is a Toyota key tied to the coat rack. The hall is to the North, the backyard to the South.

You can see the back door, a blue key, a right running shoe and a Toyota key here.

>take running shoe
(the right running shoe)
Taken.

>i
You are carrying:
  a pair of running shoes
  pants (being worn)
  underwear (being worn)
  socks (being worn)
  a shirt (being worn)
  work shoes (being worn)
  a belt (being worn)
  a hat (being worn)
  a jacket (being worn)

>wear shoes
Which do you mean, the pair of running shoes or work shoes?

>wear running shoes
You should probably take your work shoes off first.

>actions
Actions listing on.

>rules
Rules tracing now switched on. Type "rules off" to switch it off again, or "rules all" to include even rules which do not apply.

>take running shoes off
[Rule "declare everything initially unmentioned rule" applies.]
[taking off the pair of running shoes]
[Rule "announce items from multiple object lists rule" applies.]
[Rule "set pronouns from items from multiple object lists rule" applies.]
[Rule "before stage rule" applies.]
[Rule "instead stage rule" applies.]
[Rule "investigate player's awareness before action rule" applies.]
[Rule "player aware of his own actions rule" applies.]
[Rule "check stage rule" applies.]
[Rule "can't take off what's not worn rule" applies.]
You aren't wearing the pair of running shoes.
[taking off the pair of running shoes - failed the can't take off what's not worn rule]

[Rule "A first turn sequence rule" applies.]
[Rule "every turn stage rule" applies.]
[Rule "Every turn" applies.]
[Rule "A last turn sequence rule" applies.]
[Rule "notify score changes rule" applies.]

>take work shoes off
[Rule "declare everything initially unmentioned rule" applies.]
[taking off work shoes]
[Rule "announce items from multiple object lists rule" applies.]
[Rule "set pronouns from items from multiple object lists rule" applies.]
[Rule "before stage rule" applies.]
[Rule "instead stage rule" applies.]
[Rule "investigate player's awareness before action rule" applies.]
[Rule "player aware of his own actions rule" applies.]
[Rule "check stage rule" applies.]
[Rule "can't take off what's not worn rule" applies.]
[Rule "can't exceed carrying capacity when taking off rule" applies.]
[Rule "carry out stage rule" applies.]
[Rule "standard taking off rule" applies.]
[Rule "after stage rule" applies.]
[Rule "investigate player's awareness after action rule" applies.]
[Rule "report stage rule" applies.]
[Rule "standard report taking off rule" applies.]
You take off work shoes.
[Rule "last specific action-processing rule" applies.]
[taking off work shoes - succeeded]

[Rule "A first turn sequence rule" applies.]
[Rule "every turn stage rule" applies.]
[Rule "Every turn" applies.]
[Rule "A last turn sequence rule" applies.]
[Rule "notify score changes rule" applies.]

>wear running shoes
[Rule "declare everything initially unmentioned rule" applies.]
[wearing the pair of running shoes]
[Rule "announce items from multiple object lists rule" applies.]
[Rule "set pronouns from items from multiple object lists rule" applies.]
[Rule "before stage rule" applies.]
[Rule "Before wearing something" applies.]
[Rule "instead stage rule" applies.]
[Rule "investigate player's awareness before action rule" applies.]
[Rule "player aware of his own actions rule" applies.]
[Rule "check stage rule" applies.]
[Rule "can't wear what's not clothing rule" applies.]
[Rule "can't wear what's not held rule" applies.]
[Rule "can't wear what's already worn rule" applies.]
[Rule "carry out stage rule" applies.]
[Rule "standard wearing rule" applies.]
[Rule "after stage rule" applies.]
[Rule "investigate player's awareness after action rule" applies.]
[Rule "report stage rule" applies.]
[Rule "standard report wearing rule" applies.]
You put on the pair of running shoes.
[Rule "last specific action-processing rule" applies.]
[wearing the pair of running shoes - succeeded]

[Rule "A first turn sequence rule" applies.]
[Rule "every turn stage rule" applies.]
[Rule "Every turn" applies.]
[Rule "A last turn sequence rule" applies.]
[Rule "notify score changes rule" applies.]

>take running shoes off
[Rule "declare everything initially unmentioned rule" applies.]
[taking off the pair of running shoes]
[Rule "announce items from multiple object lists rule" applies.]
[Rule "set pronouns from items from multiple object lists rule" applies.]
[Rule "before stage rule" applies.]
[Rule "instead stage rule" applies.]
[Rule "investigate player's awareness before action rule" applies.]
[Rule "player aware of his own actions rule" applies.]
[Rule "check stage rule" applies.]
[Rule "can't take off what's not worn rule" applies.]
[Rule "can't exceed carrying capacity when taking off rule" applies.]
[Rule "carry out stage rule" applies.]
[Rule "standard taking off rule" applies.]
[Rule "after stage rule" applies.]
[Rule "After taking off the pair of running shoes" applies.]
You take off the running shoes.
[taking off the pair of running shoes - succeeded]

[Rule "A first turn sequence rule" applies.]
[Rule "every turn stage rule" applies.]
[Rule "Every turn" applies.]
[Rule "A last turn sequence rule" applies.]
[Rule "notify score changes rule" applies.]

* * *

>e
Kitchen
Where food happens. The hall is to the West.

You can see a toaster, a cabinet (closed), a refrigerator (closed) and a stool here.

>w
Hall
The hall in the middle of your house. Your bedroom is to the West. The staircase leading upwards is to the North. The back entryway is to the South. The kitchen is to the East. There is a muddy brown key hanging from a hook on the wall. You can also go down to the basement from here.

You can see a Staircase and a muddy brown key here.

>w
Bedroom
It's your bedroom. It's not very interesting. The hall is to the east. The side door (closed) leads out of the house to the West. 

On the nightstand is an iPod.

>w
You can't go through the Side Door because it's closed.

>open door
You open the Side Door.

>w
The Garden
A small garden. There are a few different kinds of flowers and a few different kinds of squash. It's a peaceful place. A spigot on the wall sits above a circular indent in the dirt.

You can see the shed (closed) here.

>x shed
(the shed)
A narrow rusty shed. The shed is really tall and you can't see above it.

>open shed
(the shed)
It seems to be locked.

>x spigot
You see nothing special about the spigot.

>w
Outskirts of Town
There's less town here than there is to the South. The garden is east. The space center is North. The road is West.

>w
Road
It's a road, like what people travel on. The outskirts of town are to the east. To the North you can see a fork in the road. The stream is west. The warehouse is south.

>w
By the Stream
There's a stream, making whatever sound water makes. There's also a scary warning sign. The road is to the east, and the clearing is to the south.

>x sign
The sign says BEWARE OF PIRANHAS.

>s
Clearing
It's very clear here. The edge of the woods is to the west. A hole that leads into the abandoned warehouse is to the east. There's a stream to the north.

* * *

>w
Edge of the Woods
The woods start here and extend to the west. There's a clearing to the east.

>w
As you walk into the woods, a large grizzly bear shows up, baring (bear-ing?) its teeth at you. You hastily take three steps back.
The bear seems to be guarding the entrance to the woods. Seems like it would be awfully difficult to get through here unless the bear were somehow distracted. With food, maybe?

>e
Clearing
It's very clear here. The edge of the woods is to the west. A hole that leads into the abandoned warehouse is to the east. There's a stream to the north.

>s
You can't go that way.

>n
By the Stream
There's a stream, making whatever sound water makes. There's also a scary warning sign. The road is to the east, and the clearing is to the south.

>n
You can't go that way.

>e
Road
It's a road, like what people travel on. The outskirts of town are to the east. To the North you can see a fork in the road. The stream is west. The warehouse is south.

>n
Further Along the Road
More road! There's a fork in the road here. The main road goes North and South. To the West there's a parking lot.

>x fork
You see nothing special about the fork.

>n
Abandoned Train Station
No trains.

You can see a map here.

>x map
You see a map detailing the station, the tracks, the road, and a little control room nearby.

>n
You can't go that way.

>e
Control Room
Where things get controlled.

You can see the CALL TRAIN button here.

>w
Abandoned Train Station
No trains.

You can see a map here.

>s
Further Along the Road
More road! There's a fork in the road here. The main road goes North and South. To the West there's a parking lot.

>n
Abandoned Train Station
No trains.

You can see a map here.

* * *

>e
Hall
The hall in the middle of your house. Your bedroom is to the West. The staircase leading upwards is to the North. The back entryway is to the South. The kitchen is to the East. You can also go down to the basement from here.

There is a muddy brown key hanging from a hook on the wall.

>s
Back Entryway
The back entryway to your house. It's a tiny room with a coat rack and a trash can being the most notable scenery. There is a Toyota key tied to the coat rack. The hall is to the North, the backyard to the South.

You can see the back door, a blue key, a right running shoe and a Toyota key here.

>untie key
Which do you mean, the blue key or the Toyota key?

>toyota
You untie the Toyota key, but in your clumsiness it falls to the floor.

>get toyota key
Taken.

>n
Hall
The hall in the middle of your house. Your bedroom is to the West. The staircase leading upwards is to the North. The back entryway is to the South. The kitchen is to the East. You can also go down to the basement from here.

There is a muddy brown key hanging from a hook on the wall.

>d
Basement
The dark basement of your house. The hall is upstairs. The Tunnel of Extraction is to the West.

You can see The Tunnel of Extraction, a vat (closed) and a key cabinet (in which is a small metal key) here.

>w
You go through the long and winding Tunnel of Extraction.

Abandoned Warehouse
The warehouse is old and abandoned. It is big and extends South. Not much more to say. The Road is to the North. The Tunnel of Extraction is below. There are holes in the wall to the East and West.

You can see The Tunnel of Extraction here.

* * *

>n
Road
It's a road, like what people travel on. The outskirts of town are to the East. To the North you can see a fork in the road. The stream is West. The warehouse is South.

>n
Further Along the Road
More road! There's a fork in the road here. The main road goes North and South. To the West there's a parking lot.

>n
Abandoned Train Station
No trains.

The road leads South back toward town.

You can see a map here.

>e
Control Room
Where things get controlled. The only exit is to the West.

You can see the CALL TRAIN button and an old screen here.

>press button
You press the CALL TRAIN button. Nothing happens. Maybe try pressing the button again.

>g
You press the CALL TRAIN button. Nothing happens. Maybe try pressing the button again.

>g
Now that you've been standing here for a bit, you notice a sticky note next to the button.
You press the CALL TRAIN button. Nothing happens. Maybe try pressing the button again.

>g
You press the CALL TRAIN button. Nothing happens. Maybe try pressing the button again.

>g
You press the CALL TRAIN button. Nothing happens. Maybe try pressing the button again.

I beg your pardon?

>g
You press the CALL TRAIN button. Nothing happens. Maybe try pressing the button again.

>g
You press the CALL TRAIN button. An electronic voice informs you, "The train will be here any minute now." That was easy.

>w
Abandoned Train Station
No trains.

The road leads South back toward town.

You can see a map here.

>s
Further Along the Road
More road! There's a fork in the road here. The main road goes North and South. To the West there's a parking lot.

>w
Parking Lot
Where cars park. You see your boxy blue-gray Toyota in the corner of the lot. The road is to the East.

You can see a blue car (closed and empty) here.

>open car
You open the blue car.

>get in car
You get into and start the car. It's ready to roll!

>close car
You close the blue car.

>e
Further Along the Road (in the blue car)
More road! There's a fork in the road here. The main road goes North and South. To the West there's a parking lot.

>n
The boom gates are closing, it looks like a train is coming. You probably shouldn't go to the train station right now.

>n
The boom gates are closing, it looks like a train is coming. You drive around them and toward the train station. As you go past them, a train comes and runs you over. That was really dumb.

You've reached one of this game's 14 endings! In that game you used 39 moves. The optimal number of moves is 39.
Great job, you got the optimal number of moves!

    *** You have died ***

Would you like to RESTART, RESTORE a saved game, QUIT or UNDO the last command?

>restart
Unsafe
An Interactive Fiction by Brian Chen and Jakob Weisblat
Release 8 / Serial number 190311 / Inform 7 build 6M62 (I6/v6.33 lib 6/12N) SD

Bedroom
It's your bedroom. It's not very interesting. The hall is to the East. The side door (closed) leads out of the house to the West. 

You've just gotten out of your bed, having woken up from a nap.

On the nightstand is an iPod.

>e
Hall
The hall in the middle of your house. Your bedroom is to the West. The staircase leading upwards is to the North. The back entryway is to the South. The kitchen is to the East. You can also go down to the basement from here.

There is a muddy brown key hanging from a hook on the wall.

* * *

>s
Back Entryway
The back entryway to your house. It's a tiny room with a coat rack and a trash can being the most notable scenery. There is a Toyota key tied to the coat rack. The hall is to the North, the backyard to the South.

You can see the back door, a blue key, a right running shoe and a Toyota key here.

>untie toyota
You untie the Toyota key, but in your clumsiness it falls to the floor.

>take toyota
Taken.

>n
Hall
The hall in the middle of your house. Your bedroom is to the West. The staircase leading upwards is to the North. The back entryway is to the South. The kitchen is to the East. You can also go down to the basement from here.

There is a muddy brown key hanging from a hook on the wall.

* * *

>e
Control Room
Where things get controlled. The only exit is to the West.

You can see the CALL TRAIN button and an old screen here.

>undo
Abandoned Train Station
[Previous turn undone.]

>undo
Further Along the Road
[Previous turn undone.]

>w
Parking Lot
Where cars park. You see your boxy blue-gray Toyota in the corner of the lot. The road is to the East.

You can see a blue car (closed and empty) here.

* * *

>e
Further Along the Road (in the blue car)
More road! There's a fork in the road here. The main road goes North and South. To the West there's a parking lot.

>n
You drive across the tracks into the train station turnaround. This is the end of the road.

Abandoned Train Station (in the blue car)
No trains.

The road leads South back toward town.

You can see a map here.

>e
Control Room (in the blue car)
Where things get controlled. The only exit is to the West.

You can see the CALL TRAIN button and an old screen here.

>press button
The blue car isn't open.

>undo
Control Room
[Previous turn undone.]

>open car
You open the blue car.

>press button
You press the CALL TRAIN button. Nothing happens. Maybe try pressing the button again.

* * *

>g
You press the CALL TRAIN button. An electronic voice informs you, "The train will be here any minute now." That was easy.

>g
You press the CALL TRAIN button. An electronic voice informs you, "The train will be here any minute now." That was easy.

>undo
Control Room
[Previous turn undone.]

>w
That would be unsafe. You should close the car door.

>undo
Control Room
[Previous turn undone.]

>close door
You close the blue car.

>w
The boom gates are closing, it looks like a train is coming. You probably shouldn't go to the train station right now.

>n
You can't go that way.

>n
You can't go that way.

>undo
Control Room
[Previous turn undone.]

>undo
Control Room
[Previous turn undone.]

>w
The boom gates are closing, it looks like a train is coming. You drive around them and toward the train station. As you go past them, a train comes and runs you over. That was really dumb.

You've reached one of this game's 14 endings! In that game you used 39 moves. The optimal number of moves is 39.
Great job, you got the optimal number of moves!

    *** You have died ***

Would you like to RESTART, RESTORE a saved game, QUIT or UNDO the last command?

>restart
Unsafe
An Interactive Fiction by Brian Chen and Jakob Weisblat
Release 8 / Serial number 190311 / Inform 7 build 6M62 (I6/v6.33 lib 6/12N) SD

Bedroom
It's your bedroom. It's not very interesting. The hall is to the East. The side door (closed) leads out of the house to the West. 

You've just gotten out of your bed, having woken up from a nap.

On the nightstand is an iPod.

* * *

>open car
You open the blue car.

>in car
I only understood you as far as wanting to (go) in.

>undo
Parking Lot
[Previous turn undone.]

>enter car
You get into and start the car. It's ready to roll!

>e
That would be unsafe. You should close the car door.

>undo
Parking Lot
[Previous turn undone.]

>close car
You close the blue car.

* * *

>n
You drive across the tracks into the train station turnaround. This is the end of the road.

Abandoned Train Station (in the blue car)
No trains.

The road leads South back toward town.

You can see a map here.

>n
You can't go that way.

>undo
Abandoned Train Station
[Previous turn undone.]

>e
Control Room (in the blue car)
Where things get controlled. The only exit is to the West.

You can see the CALL TRAIN button and an old screen here.

>push button
The blue car isn't open.

>undo
Control Room
[Previous turn undone.]

* * *

>open car
You open the blue car.

>push button
You press the CALL TRAIN button. Nothing happens. Maybe try pressing the button again.

>g
You press the CALL TRAIN button. Nothing happens. Maybe try pressing the button again.

* * *

>g
You press the CALL TRAIN button. An electronic voice informs you, "The train will be here any minute now." That was easy.

>close car
You close the blue car.

>w
The boom gates are closing, it looks like a train is coming. You probably shouldn't go to the train station right now.

>w
The boom gates are closing, it looks like a train is coming. You drive around them and toward the train station. As you go past them, a train comes and runs you over. That was really dumb.

You've reached one of this game's 14 endings! In that game you used 39 moves. The optimal number of moves is 39.
Great job, you got the optimal number of moves!

    *** You have died ***

Would you like to RESTART, RESTORE a saved game, QUIT or UNDO the last command?

* * *

>untie toyota
You untie the Toyota key, but in your clumsiness it falls to the floor.

>get toyota
Taken.

>n
Hall
The hall in the middle of your house. Your bedroom is to the West. The staircase leading upwards is to the North. The back entryway is to the South. The kitchen is to the East. You can also go down to the basement from here.

There is a muddy brown key hanging from a hook on the wall.

* * *

>n
Further Along the Road
More road! There's a fork in the road here. The main road goes North and South. To the West there's a parking lot.

>w
Parking Lot
Where cars park. You see your boxy blue-gray Toyota in the corner of the lot. The road is to the East.

You can see a blue car (closed and empty) here.

* * *

>e
Further Along the Road (in the blue car)
More road! There's a fork in the road here. The main road goes North and South. To the West there's a parking lot.

I beg your pardon?

>open car
You open the blue car.

>undo
Further Along the Road
[Previous turn undone.]

>n
You drive across the tracks into the train station turnaround. This is the end of the road.

Abandoned Train Station (in the blue car)
No trains.

The road leads South back toward town.

You can see a map here.

* * *

>e
Control Room (in the blue car)
Where things get controlled. The only exit is to the West.

You can see the CALL TRAIN button and an old screen here.

>w
You drive across the tracks into the train station turnaround. This is the end of the road.

Abandoned Train Station (in the blue car)
No trains.

The road leads South back toward town.

You can see a map here.

>s
Further Along the Road (in the blue car)
More road! There's a fork in the road here. The main road goes North and South. To the West there's a parking lot.

>s
Road (in the blue car)
It's a road, like what people travel on. The outskirts of town are to the East. To the North you can see a fork in the road. The stream is West. The warehouse is South.

>e
Outskirts of Town (in the blue car)
There's less town here than there is to the South. The garden is East. The space center is North. The road is West.

>e
The Garden (in the blue car)
A small garden. There are a few different kinds of flowers and a few different kinds of squash. It's a peaceful place. A spigot on the wall sits above a circular indent in the dirt. You could swear there used to be a bucket somewhere around here, but you don't see it anywhere...

The side door to your house is East, and a path leads off towards town to the West.

You can see the shed (closed) here.

>e
You can't go through the Side Door because it's closed.

>open door
(the blue car)
You open the blue car.

>e
That would be unsafe. You should close the car door.

>close door
(the blue car)
You close the blue car.

>open side door
The blue car isn't open.

>open blue car
You open the blue car.

>open side door
You open the Side Door.

>close car
You close the blue car.

>e
Bedroom (in the blue car)
It's your bedroom. It's not very interesting. The hall is to the East. The side door (open) leads out of the house to the West. 

On the nightstand is an iPod.

* * *

>d
Basement
The dark basement of your house. The hall is upstairs. The Tunnel of Extraction is to the west.

You can see The Tunnel of Extraction, a vat (closed) and a key cabinet (in which is a small metal key) here.

>take key
(the key cabinet)
(the small metal key)
Taken.

>w
You go through the long and winding Tunnel of Extraction.

Abandoned Warehouse
The warehouse is old and abandoned. It is big and extends south. Not much more to say. The Road is to the North. The Tunnel of Extraction is below. There are holes in the wall to the East and West.

You can see The Tunnel of Extraction here.

>n
Road
It's a road, like what people travel on. The outskirts of town are to the east. To the North you can see a fork in the road. The stream is west. The warehouse is south.

>e
Outskirts of Town
There's less town here than there is to the South. The garden is east. The space center is North. The road is West.

>e
The Garden
A small garden. There are a few different kinds of flowers and a few different kinds of squash. It's a peaceful place. A spigot on the wall sits above a circular indent in the dirt.

You can see the shed (closed) here.

>restart
Are you sure you want to restart?

Please answer yes or no.

>y
Unsafe
An Interactive Fiction by Brian Chen and Jakob Weisblat
Release 3 / Serial number 190227 / Inform 7 build 6M62 (I6/v6.33 lib 6/12N) SD

Bedroom
It's your bedroom. It's not very interesting. The hall is to the east. The side door (closed) leads out of the house to the West. 

You've just gotten out of your bed, having woken up from a nap.

On the nightstand is an iPod.

>e
Hall
The hall in the middle of your house. Your bedroom is to the West. The staircase leading upwards is to the North. The back entryway is to the South. The kitchen is to the East. There is a muddy brown key hanging from a hook on the wall. You can also go down to the basement from here.

You can see a Staircase and a muddy brown key here.

>d
Basement
The dark basement of your house. The hall is upstairs. The Tunnel of Extraction is to the west.

You can see The Tunnel of Extraction, a vat (closed) and a key cabinet (in which is a small metal key) here.

* * *

>n
Road
It's a road, like what people travel on. The outskirts of town are to the east. To the North you can see a fork in the road. The stream is west. The warehouse is south.

>n
Further Along the Road
More road! There's a fork in the road here. The main road goes North and South. To the West there's a parking lot.

>take fork
You try to pull the fork out of the road, but it's pretty stuck. Your hand slips off the fork just as you feel it has dislodged slightly from the road.

>take
What do you want to take?

>undo
Further Along the Road
[Previous turn undone.]

>take fork
Taken.

>s
Road
It's a road, like what people travel on. The outskirts of town are to the east. To the North you can see a fork in the road. The stream is west. The warehouse is south.

>s
Abandoned Warehouse
The warehouse is old and abandoned. It is big and extends south. Not much more to say. The Road is to the North. The Tunnel of Extraction is below. There are holes in the wall to the East and West.

You can see The Tunnel of Extraction here.

>go tunnel
Basement
The dark basement of your house. The hall is upstairs. The Tunnel of Extraction is to the west.

You can see The Tunnel of Extraction, a vat (closed) and a key cabinet (in which is a small metal key) here.

>u
Hall
The hall in the middle of your house. Your bedroom is to the West. The staircase leading upwards is to the North. The back entryway is to the South. The kitchen is to the East. There is a muddy brown key hanging from a hook on the wall. You can also go down to the basement from here.

You can see a Staircase and a muddy brown key here.

>e
Kitchen
Where food happens. The hall is to the west.

You can see a toaster, a cabinet (closed), a refrigerator (closed) and a stool here.

>plug in toaster
You plug in the toaster.

>open cabinet
You open the cabinet, revealing a top drawer, a middle drawer and a bottom drawer.

>open middle drawer
You open the middle drawer, revealing a big tupperware container.

>open tupperware
You open the big tupperware container, revealing a loaf of bread.

>take bread
Taken.

>open bread
You take off the plastic wrap and now the bread smells heavenly.

>put bread in toaster
You put a slice of bread in the toaster.

>put bread in toaster
You put a slice of bread in the toaster.

>push button
The bread recedes into the toaster, and the coils start to light up red. In just a minute, you'll have some tasty tasty toast.

>wait
Time passes.

>wait
Time passes.

DING! The toast is ready. The toaster pops it out but malfunctions and the toast becomes stuck in the toaster.

>put fork in toaster
You stick the fork in the toaster, hoping it will help you remove your toast. Unfortunately, the toaster is electrified and as soon as your fork touches the coil you are electrocuted. You'll never get to eat that delicious toast... :(

You've reached one of this game's 14 endings! In that game you used 24 moves. The optimal number of moves is 24.
Great job, you got the optimal number of moves!

    *** You have died ***

Would you like to RESTART, RESTORE a saved game, QUIT or UNDO the last command?

>restart
Unsafe
An Interactive Fiction by Brian Chen and Jakob Weisblat
Release 3 / Serial number 190227 / Inform 7 build 6M62 (I6/v6.33 lib 6/12N) SD

Bedroom
It's your bedroom. It's not very interesting. The hall is to the east. The side door (closed) leads out of the house to the West. 

You've just gotten out of your bed, having woken up from a nap.

On the nightstand is an iPod.

* * *

>e
The Garden
A small garden. There are a few different kinds of flowers and a few different kinds of squash. It's a peaceful place. A spigot on the wall sits above a circular indent in the dirt.

You can see the shed (closed) here.

>unlock shed with brown key
(the shed with the muddy brown key)
You unlock the shed.

>get cage
You can't see any such thing.

>take cage
You can't see any such thing.

>open shed
(the shed)
You open the shed, revealing a cage.

>take cage
You take a minute to brush the road dirt off of your shoes so that the shed doesn't get dirty.

* * *

>l
Hall
The hall in the middle of your house. Your bedroom is to the West. The staircase leading upwards is to the North. The back entryway is to the South. The kitchen is to the East. You can also go down to the basement from here.

>w
Bedroom
It's your bedroom. It's not very interesting. The hall is to the east. The side door (closed) leads out of the house to the West. 

On the nightstand is an iPod.

>drop key
Dropped.

>l
Bedroom
It's your bedroom. It's not very interesting. The hall is to the east. The side door (closed) leads out of the house to the West. 

On the nightstand is an iPod.

You can also see a muddy brown key here.

>-e
That's not a verb I recognise.

>e
Hall
The hall in the middle of your house. Your bedroom is to the West. The staircase leading upwards is to the North. The back entryway is to the South. The kitchen is to the East. You can also go down to the basement from here.

>e
Kitchen
Where food happens. The hall is to the west.

You can see a toaster, a cabinet (closed), a refrigerator (closed) and a stool here.

>help e
"north", "south", "east", "west", "up", "down", "northeast", "northwest", "southeast", "southwest": Move around. 

You can abbreviate these movement commands to one or two letters: "n", "s", "e", "w", "u", "d", "ne", "nw", "se", "nw". 

These commands let you move around. You will walk out of the room, and into a nearby room, in the given direction. 

If the game replies "You can't go that way," then there is no exit in that direction. Try "look" to see what directions you can go.

>help bucket
There is no help information on that subject. Type "help" for subjects you can learn about.

>climb stool
You get onto the stool.

>e
(first getting off the stool)
You can't go that way.

>w
Hall
The hall in the middle of your house. Your bedroom is to the West. The staircase leading upwards is to the North. The back entryway is to the South. The kitchen is to the East. You can also go down to the basement from here.

>u
Upstairs Hall
The second floor of your house. Stairs lead down. The study is west, and the bathroom is east.

You can see a left running shoe here.

>e
Bathroom
It's just a bathroom.

You can see a mirror, a medicine cabinet (closed) and a bathtub (empty) here.

>turn faucet
You turn on the faucet. Water starts flowing out.

>turn faucet on
You turn on the faucet. Water starts flowing out.

>x tub
It's a bathtub. Big enough to sit in comfortably or lie down in uncomfortably. 

The drain is unplugged. The faucet is on. The tub has no water in it.

>plug drain
You plug the drain.

>x tub
It's a bathtub. Big enough to sit in comfortably or lie down in uncomfortably. 

The drain is plugged. The faucet is on. The water is around 10% of the way up the edge of the tub.

>l
Bathroom
It's just a bathroom.

You can see a mirror, a medicine cabinet (closed) and a bathtub here.

>l
Bathroom
It's just a bathroom.

You can see a mirror, a medicine cabinet (closed) and a bathtub here.

I beg your pardon?

>l
Bathroom
It's just a bathroom.

You can see a mirror, a medicine cabinet (closed) and a bathtub (overflowing) here.

The tub overflows and a fair amount of water flows out of the bathtub into the rest of the bathroom.

>x tub
It's a bathtub. Big enough to sit in comfortably or lie down in uncomfortably. 

The drain is plugged. The faucet is on. The water is around 100% of the way up the edge of the tub.
 the bathtub is overflowing into the bathroom. For some reason, you don't really care about this.

The tub overflows and a fair amount of water flows out of the bathtub into the rest of the bathroom.

>l
Bathroom
It's just a bathroom.

You can see a mirror, a medicine cabinet (closed) and a bathtub (overflowing) here.

The tub overflows and a fair amount of water flows out of the bathtub into the rest of the bathroom.

>w
Upstairs Hall
The second floor of your house. Stairs lead down. The study is west, and the bathroom is east.

You can see a left running shoe here.

* * *

>e
Hall
The hall in the middle of your house. Your bedroom is to the West. The staircase leading upwards is to the North. The back entryway is to the South. The kitchen is to the East. You can also go down to the basement from here.

There is a muddy brown key hanging from a hook on the wall.

>take shed key
You can't see any such thing.

>undo
Hall
[Previous turn undone.]

>take key
Taken.

>w
Bedroom
It's your bedroom. It's not very interesting. The hall is to the East. The side door (closed) leads out of the house to the West. 

On the nightstand is an iPod.

>w
You can't go through the Side Door because it's closed.

>undo
Bedroom
[Previous turn undone.]

>open door
You open the Side Door.

* * *

>w
The Garden
A small garden. There are a few different kinds of flowers and a few different kinds of squash. It's a peaceful place. A spigot on the wall sits above a circular indent in the dirt. You could swear there used to be a bucket somewhere around here, but you don't see it anywhere...

The side door to your house is East, and a path leads off towards town to the West.

You can see the shed (closed) here.

>unlock shed
What do you want to unlock the shed with?

>key
You can't see any such thing.

>undo
The Garden
[Previous turn undone.]

>unlock shed with brown key
(the shed with the muddy brown key)
You unlock the shed.

>take cage
You can't see any such thing.

>l
The Garden
A small garden. There are a few different kinds of flowers and a few different kinds of squash. It's a peaceful place. A spigot on the wall sits above a circular indent in the dirt. You could swear there used to be a bucket somewhere around here, but you don't see it anywhere...

The side door to your house is East, and a path leads off towards town to the West.

You can see the shed (closed) here.

>undo
The Garden
[Previous turn undone.]

>open shed
(the shed)
You open the shed, revealing a cage.

>take cage
Taken.

>e
Bedroom
It's your bedroom. It's not very interesting. The hall is to the East. The side door (open) leads out of the house to the West. 

On the nightstand is an iPod.

>e
Hall
The hall in the middle of your house. Your bedroom is to the West. The staircase leading upwards is to the North. The back entryway is to the South. The kitchen is to the East. You can also go down to the basement from here.

>d
Basement
The dark basement of your house. The hall is upstairs. The Tunnel of Extraction is to the West.

You can see The Tunnel of Extraction, a vat (closed) and a key cabinet (in which is a small metal key) here.

>open cabinet
That's already open.

>undo
Basement
[Previous turn undone.]

>take cage key
I only understood you as far as wanting to take the cage.

>undo
Basement
[Previous turn undone.]

>take metal key
Taken.

>w
You go through the long and winding Tunnel of Extraction.

Abandoned Warehouse
The warehouse is old and abandoned. It is big and extends South. Not much more to say. The Road is to the North. The Tunnel of Extraction is below. There are holes in the wall to the East and West.

You can see The Tunnel of Extraction here.

>s
A Spooky Lair
A lair in which a demonic ritual might be held. There is a table with a pentagram drawn on it. It's the South end of the warehouse; the only exit is North, to the rest of the warehouse.

On the table are a candle and a sacrificial knife.

You can also see a snake and an ancient cabinet (closed) here.

>drop cage
Dropped.

>open cabinet
You open the ancient cabinet, revealing three canisters.

>take canister
Taken.

>open canister
You open the canister, revealing a mouse.

>take mouse
Taken.

>drop mouse
The mouse sees an opportunity and scurries off before it can be eaten by a snake or put back in the canister.

>undo
A Spooky Lair
[Previous turn undone.]

>drop mouse in cage
A rattlesnake rushes into the cage and hungrily slurps up the mouse before it even has time to get its bearings.

Living up to its name, the snake rattles at you from the cage.

>l
A Spooky Lair
A lair in which a demonic ritual might be held. There is a table with a pentagram drawn on it. It's the South end of the warehouse; the only exit is North, to the rest of the warehouse.

On the table are a candle and a sacrificial knife.

You can also see a cage (in which is a snake) and an ancient cabinet (in which are two canisters (closed)) here.

Living up to its name, the snake rattles at you from the cage.

>undo
A Spooky Lair
[Previous turn undone.]

>lock cage
What do you want to lock the cage with?

>key
Which do you mean, the small metal key or the muddy brown key?

>metal
First you would have to close the cage.

Living up to its name, the snake rattles at you from the cage.

>undo
A Spooky Lair
[Previous turn undone.]

>close cage
You close the cage.

Living up to its name, the snake rattles at you from the cage.

>lock cage
What do you want to lock the cage with?

* * *

>key
Which do you mean, the small metal key or the muddy brown key?

>metal
You lock the cage.

Living up to its name, the snake rattles at you from the cage.

Angry at being locked up and not wanting to be a pet, the snake breaks through the cage and attaches itself to your eye. You feeel the effects of the venom almost immediately.

You've reached one of this game's 14 endings! In that game you used 22 moves. The optimal number of moves is 22.
Great job, you got the optimal number of moves!

    *** You have died ***

Would you like to RESTART, RESTORE a saved game, QUIT or UNDO the last command?

* * *

>e
Hall
The hall in the middle of your house. Your bedroom is to the West. The staircase leading upwards is to the North. The back entryway is to the South. The kitchen is to the East. You can also go down to the basement from here.

There is a muddy brown key hanging from a hook on the wall.

>u
Upstairs Hall
The second floor of your house. Stairs lead down. The study is west, and the bathroom is east.

You can see a Staircase and a left running shoe here.

* * *

>w
Study
Where you study. The hall is east.

On the desk are a dime and a quarter.

You can also see the closet door here.

>e
Upstairs Hall
The second floor of your house. Stairs lead down. The study is west, and the bathroom is east.

You can see a Staircase and a left running shoe here.

>e
Bathroom
It's just a bathroom.

You can see a mirror, a medicine cabinet (closed) and a bathtub (empty) here.

>get in tub
You are a person of few principles, but one of those principles is never to enter a bathtub while wearing anything. (You're wearing pants, underwear, socks, a shirt, work shoes, a belt, a hat and a jacket.)

>get out of tub
I only understood you as far as wanting to get outside.

>take off jacket
You take off the jacket.

>restart
Are you sure you want to restart?

>y
Unsafe
An Interactive Fiction by Brian Chen and Jakob Weisblat
Release 3 / Serial number 190226 / Inform 7 build 6M62 (I6/v6.33 lib 6/12N) SD

Bedroom
It's your bedroom. It's not very interesting. The hall is to the east. The side door (closed) leads out of the house to the West. 

You've just gotten out of your bed, having woken up from a nap.

On the nightstand is an iPod.

* * *

>undo
Bathroom
[Previous turn undone.]

>unplug drain
You unplug the drain.
All the water in the bathtub drains out through the drain. That was faster than it should be. Gotta call the plumber eventually..

>x tub
It's a bathtub. Big enough to sit in comfortably or lie down in uncomfortably. 

The drain is unplugged. The faucet is on. The tub has no water in it.

>get in tub
You get into the bathtub.

>get out of tub
I only understood you as far as wanting to get outside.

>get out
You get out of the bathtub.

Bathroom
It's just a bathroom.

You can see a mirror, a medicine cabinet (closed) and a bathtub (empty) here.

>get in
You get into the bathtub.

>go outside
You would have to get out of the bathtub first.

>get out of tub
I only understood you as far as wanting to get outside.

>get out of bathtub
I only understood you as far as wanting to get outside.

>leave
You get out of the bathtub.

Bathroom
It's just a bathroom.

You can see a mirror, a medicine cabinet (closed) and a bathtub (empty) here.

>get in
You get into the bathtub.

>leave tub
I only understood you as far as wanting to leave.

* * *

Welcome to Unsafe. If you're not sure what to do, type "help".

Bedroom
It's your bedroom. It's not very interesting. The hall is to the East. The side door (closed) leads out of the house to the West. 

You've just gotten out of your bed, having woken up from a nap.

On the nightstand is an iPod.

>help
This tutorial has lots of built-in help on how to play text adventures. To read more, type "help" followed by whatever it is you want to get help on, and then hit enter. For example, you can type "help basics" to see the most important IF commands.

Topics you can get help on: 

"help basics": The most important IF commands 
"help commands": Some more common commands 
"help talking": Commands for talking to other characters 
"help system": Saving and loading games, quitting, and other system commands 
"help special": Useful odds and ends (which may work differently in different games) 
"help strategy": Figuring out what to do, when you're stuck 

All of these topics are general information on playing IF. If you are stuck on a particular puzzle in Unsafe, you're on your own.

>help basics
These are the commands you will use most often. 

"look" or "l": Look around the room -- repeat the description of everything you see. 
"examine" or "x": Look more closely at something -- learn more about it. 
"inventory" or "i": List everything you're carrying. 
"north", "south", "east", "west", etc., or "n", "s", "e", "w", etc.: Walk in some direction. 

For more about these commands -- or any command used in this game -- type "help" followed by the command word. For example, "help look". You might want to start by looking at the help information for all of these basic commands.

For even more help topics and commands, just type "help".

>help commands
These are the most common ways of interacting with the game's world. It's usually worth trying these, in almost any situation. You never know what might happen -- or what you might learn. 

These commands do what they say. Common sense applies. There are many more possibilities -- every game has its own variations, depending on what actions make sense in a particular situation. For more information, type "help" followed by any command word. 

"get thing", "drop thing" 
"put this in that", "put this on that", "throw this at that" 
"push thing", "pull thing", "turn thing" 
"open thing", "close thing" 
"lock this with that", "unlock this with that" 
"touch thing", "smell thing", "listen to thing" 
"eat thing", "drink thing" 
"wear thing", "remove thing" 
"search thing", "look in thing" "look under thing", "look behind thing" 
"enter thing", "sit on thing", "climb thing" 
"get in thing", "get off thing", "get out of thing" 
"break thing", "cut thing", "crush thing" 
"wait"

>help talking
Communicating with other characters is a tricky topic. Different games handle it in different ways. One approach is to present you with a menu -- when you meet someone, you can choose what to say from a list of phrases or questions. 

Other games leave the interaction up to you. The game tells you that there's another person in the room, and then presents you with the usual command prompt. The possible commands will vary from game to game, but these are usually available: 

"talk to person" 
"ask person about topic" 
"tell person about topic" 
"say word to person" 
"ask person for thing" 
"give thing to person" 
"show thing to person" 

You can also talk to a person by typing "person, phrase". (The comma is important.) For example, to answer a question, you could type "morgan, yes" or "morgan, no". Saying "pirate, hello" can begin an interesting conversation -- or a deadly one. To order someone around, you could use a command like "jeeves, get my umbrella" or "ensign rosen, stop the ship". (Naturally, not everyone will be willing to obey your commands!)

>help system
These commands help you manage your playing experience. (They're not actions you take inside the game world.) 

For more about these commands, type "help" followed by the command word. 

"save" Save a file containing your current game position. 
"restore": Restore a saved game; return to the saved position. 
"quit": End the game. 
"restart": Start the game over from the beginning. 
"undo": Take back your last move. 
"again": Repeat your last move. 
"script": Begin saving a transcript file of your game session. 
"script off": Turn off "script" mode.

>help special
This is a somewhat miscellaneous grab-bag of commands which help you in playing a game. Not all games will support all of them, or handle them all the same way! 

For more information on any of these commands, type "help" followed by the command word. 

"about": Read a brief introduction to the game. 
"verbose": See a detailed description of each room you enter, every time. 
"brief": Abbreviate room descriptions that you've seen before. 
"score": Measure your progress in the game. 
"help": Learn about playing interactive fiction.

>verbose
Unsafe is now in its "verbose" mode, which always gives long descriptions of locations (even if you've been there before).

>score
There is no score in this story.

>help strategy
Every text adventure is different. But here are some simple ideas which will help you in nearly any game. 

* Examine everything. (Type "examine" for more on this command.) Even if there are many things in the room, try to examine each one, at least once. Be systematic. 

* Notice which objects the game is focussing your attention on, and which seem to be background or scenery. (If it looks like the most important thing in the room, it probably is. If the game says it's not important, it probably isn't.) 

* Try to interact with things. Use common sense. If you see a button, push it. If you find a flute, play it. And "take" anything that you can possibly lift. 

* If you try a command on an object, and you get a distinctive response, your ears should perk up. It means you're on the right track. Maybe you have to try a related command, or change something else in the environment, or bring a second object in somehow. Maybe you won't be able to complete the action until later in the game. But it's important. 

* Notice when the game is leading you towards a specific command. If the game says "You could probably bend the bars," then "bend bars" is worth trying. 

* Pay attention to common elements. If you find rubies and emeralds, look for red and green places to sell, put, or drop them. If a machine is made of brass, look for a brass part to add to it. If a door is barred by shimmering silver light, look for anything that magically glows with a similar light. 

* When you find something which moves by itself, hang out and watch it for a while. You may need to understand its entire range of movement. 

And remember, the game world is a world. It has its own logic -- whimsy or dream logic perhaps, but still sense. Find the game's time and reason, and follow it. You will find a way through.

>l
Bedroom
It's your bedroom. It's not very interesting. The hall is to the East. The side door (closed) leads out of the house to the West. 

On the nightstand is an iPod.

>i
You are carrying:
  pants (being worn)
  underwear (being worn)
  socks (being worn)
  a shirt (being worn)
  work shoes (being worn)
  a belt (being worn)
  a hat (being worn)
  a jacket (being worn)

>drop all
What do you want to drop those things in?

>take all
iPod: Taken.

>take pants
You already have that.

>take off pants
You need to take your shoes off first!

>take off shoes
You take off work shoes.

>take off all
You can't see any such thing.

>take off pants
You need to take your belt off first!

>take off belt
You take off the belt.

>take off pants
You take off pants.

>i
You are carrying:
  an iPod
  pants
  underwear (being worn)
  socks (being worn)
  a shirt (being worn)
  work shoes
  a belt
  a hat (being worn)
  a jacket (being worn)

>x pants
You see nothing special about pants.

>restart
Are you sure you want to restart?

>y
Welcome to Unsafe. If you're not sure what to do, type "help".

Bedroom
It's your bedroom. It's not very interesting. The hall is to the East. The side door (closed) leads out of the house to the West. 

You've just gotten out of your bed, having woken up from a nap.

On the nightstand is an iPod.

>take ipod
Taken.

>e
Hall
The hall in the middle of your house. Your bedroom is to the West. The staircase leading upwards is to the North. The back entryway is to the South. The kitchen is to the East. You can also go down to the basement from here.

There is a muddy brown key hanging from a hook on the wall.

>u
Upstairs Hall
The second floor of your house. Stairs lead down. The study is West, and the bathroom is East.

You can see a left running shoe here.

>w
Study
Where you study. The hall is East.

On the desk are a dime and a quarter.

You can also see the closet door here.

>x desk
(the desk)
It's a sturdy wooden desk. There's a drawer.

On the desk are a dime and a quarter.

>open drawer
You open the desk drawer, revealing earbuds.

* * *

>i
You are carrying:
  an iPod
  pants (being worn)
  underwear (being worn)
  socks (being worn)
  a shirt (being worn)
  work shoes (being worn)
  a belt (being worn)
  a hat (being worn)
  a jacket (being worn)

>x earbuds
The earbuds are red.

>l
Study
Where you study. The hall is East.

On the desk are a dime and a quarter.

You can also see the closet door here.

>x drawer
In the desk drawer is earbuds.

>rules
Rules tracing now switched on. Type "rules off" to switch it off again, or "rules all" to include even rules which do not apply.

>wear earbuds
[Rule "declare everything initially unmentioned rule" applies.]
[Rule "announce items from multiple object lists rule" applies.]
[Rule "set pronouns from items from multiple object lists rule" applies.]
[Rule "before stage rule" applies.]
[Rule "Before wearing something" applies.]
[Rule "A first turn sequence rule" applies.]
[Rule "every turn stage rule" applies.]
[Rule "Every turn" applies.]
[Rule "A last turn sequence rule" applies.]
[Rule "notify score changes rule" applies.]

>take earbuds
[Rule "declare everything initially unmentioned rule" applies.]
[Rule "announce items from multiple object lists rule" applies.]
[Rule "set pronouns from items from multiple object lists rule" applies.]
[Rule "before stage rule" applies.]
[Rule "instead stage rule" applies.]
[Rule "investigate player's awareness before action rule" applies.]
[Rule "player aware of his own actions rule" applies.]
[Rule "check stage rule" applies.]
[Rule "can't take yourself rule" applies.]
[Rule "can't take other people rule" applies.]
[Rule "can't take component parts rule" applies.]
[Rule "can't take people's possessions rule" applies.]
[Rule "can't take items out of play rule" applies.]
[Rule "can't take what you're inside rule" applies.]
[Rule "can't take what's already taken rule" applies.]
[Rule "can't take scenery rule" applies.]
[Rule "can only take things rule" applies.]
[Rule "can't take what's fixed in place rule" applies.]
[Rule "use player's holdall to avoid exceeding carrying capacity rule" applies.]
[Rule "can't exceed carrying capacity rule" applies.]
[Rule "carry out stage rule" applies.]
[Rule "standard taking rule" applies.]
[Rule "after stage rule" applies.]
[Rule "investigate player's awareness after action rule" applies.]
[Rule "report stage rule" applies.]
[Rule "standard report taking rule" applies.]
Taken.
[Rule "last specific action-processing rule" applies.]

[Rule "A first turn sequence rule" applies.]
[Rule "every turn stage rule" applies.]
[Rule "Every turn" applies.]
[Rule "A last turn sequence rule" applies.]
[Rule "notify score changes rule" applies.]

>wear earbuds
[Rule "declare everything initially unmentioned rule" applies.]
[Rule "announce items from multiple object lists rule" applies.]
[Rule "set pronouns from items from multiple object lists rule" applies.]
[Rule "before stage rule" applies.]
[Rule "Before wearing something" applies.]
[Rule "instead stage rule" applies.]
[Rule "investigate player's awareness before action rule" applies.]
[Rule "player aware of his own actions rule" applies.]
[Rule "check stage rule" applies.]
[Rule "can't wear what's not clothing rule" applies.]
[Rule "can't wear what's not held rule" applies.]
[Rule "can't wear what's already worn rule" applies.]
[Rule "carry out stage rule" applies.]
[Rule "standard wearing rule" applies.]
[Rule "after stage rule" applies.]
[Rule "investigate player's awareness after action rule" applies.]
[Rule "report stage rule" applies.]
[Rule "standard report wearing rule" applies.]
You put on earbuds.
[Rule "last specific action-processing rule" applies.]

[Rule "A first turn sequence rule" applies.]
[Rule "every turn stage rule" applies.]
[Rule "Every turn" applies.]
[Rule "A last turn sequence rule" applies.]
[Rule "notify score changes rule" applies.]

>i
[Rule "declare everything initially unmentioned rule" applies.]
[Rule "announce items from multiple object lists rule" applies.]
[Rule "set pronouns from items from multiple object lists rule" applies.]
[Rule "before stage rule" applies.]
[Rule "instead stage rule" applies.]
[Rule "investigate player's awareness before action rule" applies.]
[Rule "player aware of his own actions rule" applies.]
[Rule "check stage rule" applies.]
[Rule "carry out stage rule" applies.]
[Rule "print empty inventory rule" applies.]
[Rule "print standard inventory rule" applies.]
You are carrying:
  earbuds (being worn)
  an iPod
  pants (being worn)
  underwear (being worn)
  socks (being worn)
  a shirt (being worn)
  work shoes (being worn)
  a belt (being worn)
  a hat (being worn)
  a jacket (being worn)
[Rule "after stage rule" applies.]

[Rule "investigate player's awareness after action rule" applies.]
[Rule "report stage rule" applies.]
[Rule "report other people taking inventory rule" applies.]
[Rule "last specific action-processing rule" applies.]
[Rule "A first turn sequence rule" applies.]
[Rule "every turn stage rule" applies.]
[Rule "Every turn" applies.]
[Rule "A last turn sequence rule" applies.]
[Rule "notify score changes rule" applies.]

>drop jacket
[Rule "declare everything initially unmentioned rule" applies.]
[Rule "announce items from multiple object lists rule" applies.]
[Rule "set pronouns from items from multiple object lists rule" applies.]
[Rule "before stage rule" applies.]
[Rule "instead stage rule" applies.]
[Rule "investigate player's awareness before action rule" applies.]
[Rule "player aware of his own actions rule" applies.]
[Rule "check stage rule" applies.]
[Rule "can't drop yourself rule" applies.]
[Rule "can't drop what's already dropped rule" applies.]
[Rule "can't drop what's not held rule" applies.]
[Rule "can't drop clothes being worn rule" applies.]
(first taking the jacket off)
[Rule "announce items from multiple object lists rule" applies.]
[Rule "set pronouns from items from multiple object lists rule" applies.]
[Rule "before stage rule" applies.]
[Rule "instead stage rule" applies.]
[Rule "investigate player's awareness before action rule" applies.]
[Rule "player aware of his own actions rule" applies.]
[Rule "check stage rule" applies.]
[Rule "can't take off what's not worn rule" applies.]
[Rule "can't exceed carrying capacity when taking off rule" applies.]
[Rule "carry out stage rule" applies.]
[Rule "standard taking off rule" applies.]
[Rule "after stage rule" applies.]
[Rule "investigate player's awareness after action rule" applies.]
[Rule "report stage rule" applies.]
[Rule "last specific action-processing rule" applies.]
[Rule "can't drop if this exceeds carrying capacity rule" applies.]
[Rule "carry out stage rule" applies.]
[Rule "standard dropping rule" applies.]
[Rule "after stage rule" applies.]
[Rule "investigate player's awareness after action rule" applies.]
[Rule "report stage rule" applies.]
[Rule "standard report dropping rule" applies.]
Dropped.
[Rule "last specific action-processing rule" applies.]

[Rule "A first turn sequence rule" applies.]
[Rule "every turn stage rule" applies.]
[Rule "Every turn" applies.]
[Rule "A last turn sequence rule" applies.]
[Rule "notify score changes rule" applies.]

>wear jacket
[Rule "declare everything initially unmentioned rule" applies.]
[Rule "announce items from multiple object lists rule" applies.]
[Rule "set pronouns from items from multiple object lists rule" applies.]
[Rule "before stage rule" applies.]
[Rule "Before wearing something" applies.]
[Rule "A first turn sequence rule" applies.]
[Rule "every turn stage rule" applies.]
[Rule "Every turn" applies.]
[Rule "A last turn sequence rule" applies.]
[Rule "notify score changes rule" applies.]

* * *

>help look
"look": Look around the room. 

(You can abbreviate this as "l".) 

Take a look around. This repeats the description of the room, and lists everything you see nearby. 

If you are having trouble understanding where you are, or what's going on in the game, it never hurts to "look". 

Remember, you also can "examine" anything you see, to inspect it in more detail.

>help go
"north", "south", "east", "west", "up", "down", "northeast", "northwest", "southeast", "southwest": Move around. 

You can abbreviate these movement commands to one or two letters: "n", "s", "e", "w", "u", "d", "ne", "nw", "se", "nw". 

These commands let you move around. You will walk out of the room, and into a nearby room, in the given direction. 

If the game replies "You can't go that way," then there is no exit in that direction. Try "look" to see what directions you can go.

>help strategy
Every text adventure is different. But here are some simple ideas which will help you in nearly any game. 

* Examine everything. (Type "examine" for more on this command.) Even if there are many things in the room, try to examine each one, at least once. Be systematic. 

* Notice which objects the game is focussing your attention on, and which seem to be background or scenery. (If it looks like the most important thing in the room, it probably is. If the game says it's not important, it probably isn't.) 

* Try to interact with things. Use common sense. If you see a button, push it. If you find a flute, play it. And "take" anything that you can possibly lift. 

* If you try a command on an object, and you get a distinctive response, your ears should perk up. It means you're on the right track. Maybe you have to try a related command, or change something else in the environment, or bring a second object in somehow. Maybe you won't be able to complete the action until later in the game. But it's important. 

* Notice when the game is leading you towards a specific command. If the game says "You could probably bend the bars," then "bend bars" is worth trying. 

* Pay attention to common elements. If you find rubies and emeralds, look for red and green places to sell, put, or drop them. If a machine is made of brass, look for a brass part to add to it. If a door is barred by shimmering silver light, look for anything that magically glows with a similar light. 

* When you find something which moves by itself, hang out and watch it for a while. You may need to understand its entire range of movement. 

And remember, the game world is a world. It has its own logic -- whimsy or dream logic perhaps, but still sense. Find the game's time and reason, and follow it. You will find a way through.

>help bucket
There is no help information on that subject. Type "help" for subjects you can learn about.

>help
This tutorial has lots of built-in help on how to play text adventures. To read more, type "help" followed by whatever it is you want to get help on, and then hit enter.

Topics you can get help on: 

"help basics": The most important IF commands 
"help commands": Some more common commands 
"help talking": Commands for talking to other characters 
"help system": Saving and loading games, quitting, and other system commands 
"help special": Useful odds and ends (which may work differently in different games) 
"help strategy": Figuring out what to do, when you're stuck 

All of these topics are general information on playing IF. If you are stuck on a particular puzzle in Unsafe, you're on your own.

>help commands
These are the most common ways of interacting with the game's world. It's usually worth trying these, in almost any situation. You never know what might happen -- or what you might learn. 

These commands do what they say. Common sense applies. There are many more possibilities -- every game has its own variations, depending on what actions make sense in a particular situation. For more information, type "help" followed by any command word. 

"get thing", "drop thing" 
"put this in that", "put this on that", "throw this at that" 
"push thing", "pull thing", "turn thing" 
"open thing", "close thing" 
"lock this with that", "unlock this with that" 
"touch thing", "smell thing", "listen to thing" 
"eat thing", "drink thing" 
"wear thing", "remove thing" 
"search thing", "look in thing" "look under thing", "look behind thing" 
"enter thing", "sit on thing", "climb thing" 
"get in thing", "get off thing", "get out of thing" 
"break thing", "cut thing", "crush thing" 
"wait"

* * *

Welcome to Unsafe. If you're not sure what to do, type "help".

Bedroom
It's your bedroom. It's not very interesting. The hall is to the East. The side door (closed) leads out of the house to the West. 

You've just gotten out of your bed, having woken up from a nap.

On the nightstand is an iPod.

>l
Bedroom
It's your bedroom. It's not very interesting. The hall is to the East. The side door (closed) leads out of the house to the West. 

On the nightstand is an iPod.

>e
Hall
The hall in the middle of your house. Your bedroom is to the West. The staircase leading upwards is to the North. The back entryway is to the South. The kitchen is to the East. You can also go down to the basement from here.

There is a muddy brown key hanging from a hook on the wall.

>take key
Taken.

>e
Kitchen
Where food happens. The hall is to the West.

You can see a toaster, a cabinet (closed), a refrigerator (closed) and a stool here.

>s
You can't go that way.

>w
Hall
The hall in the middle of your house. Your bedroom is to the West. The staircase leading upwards is to the North. The back entryway is to the South. The kitchen is to the East. You can also go down to the basement from here.

>w
Bedroom
It's your bedroom. It's not very interesting. The hall is to the East. The side door (closed) leads out of the house to the West. 

On the nightstand is an iPod.

* * *

>w
You can't go through the Side Door because it's closed.

>w
You can't go through the Side Door because it's closed.

* * *

>open door
You open the Side Door.

I beg your pardon?

>l
Bedroom
It's your bedroom. It's not very interesting. The hall is to the East. The side door (open) leads out of the house to the West. 

On the nightstand is an iPod.

>w
The Garden
A small garden. There are a few different kinds of flowers and a few different kinds of squash. It's a peaceful place. A spigot on the wall sits above a circular indent in the dirt. You could swear there used to be a bucket somewhere around here, but you don't see it anywhere...

The side door to your house is East, and a path leads off towards town to the West.

You can see the shed (closed) here.

>i
You are carrying:
  a muddy brown key
  pants (being worn)
  underwear (being worn)
  socks (being worn)
  a shirt (being worn)
  work shoes (being worn)
  a belt (being worn)
  a hat (being worn)
  a jacket (being worn)

>e
Bedroom
It's your bedroom. It's not very interesting. The hall is to the East. The side door (open) leads out of the house to the West. 

On the nightstand is an iPod.

>u
You can't go that way.

>e
Hall
The hall in the middle of your house. Your bedroom is to the West. The staircase leading upwards is to the North. The back entryway is to the South. The kitchen is to the East. You can also go down to the basement from here.

>u
Upstairs Hall
The second floor of your house. Stairs lead down. The study is West, and the bathroom is East.

You can see a left running shoe here.

* * *

>w
Study
Where you study. The hall is East.

On the desk are a dime and a quarter.

You can also see the closet door here.

>open drawer
You open the desk drawer, revealing earbuds.

>ake earbuds
That's not a verb I recognise.

>take earbuds
Taken.

>wear earbuds
You put on earbuds.

>e
Upstairs Hall
The second floor of your house. Stairs lead down. The study is West, and the bathroom is East.

You can see a left running shoe here.

>d
Hall
The hall in the middle of your house. Your bedroom is to the West. The staircase leading upwards is to the North. The back entryway is to the South. The kitchen is to the East. You can also go down to the basement from here.

>d
Basement
The dark basement of your house. The hall is upstairs. The Tunnel of Extraction is to the West.

You can see The Tunnel of Extraction, a vat (closed) and a key cabinet (in which is a small metal key) here.

>d
You can't go that way.

>w
You go through the long and winding Tunnel of Extraction.

As you follow all the twists and turns of the tunnel, you turn your head one too many times and your earbuds fall out of your ears. You manage to grab them before you lose them, though.

Abandoned Warehouse
The warehouse is old and abandoned. It is big and extends South. Not much more to say. The Road is to the North. The Tunnel of Extraction is below. There are holes in the wall to the East and West.

You can see The Tunnel of Extraction here.

>i
You are carrying:
  earbuds
  a muddy brown key
  pants (being worn)
  underwear (being worn)
  socks (being worn)
  a shirt (being worn)
  work shoes (being worn)
  a belt (being worn)
  a hat (being worn)
  a jacket (being worn)

* * *

Welcome to Unsafe. If you're not sure what to do, type "help".

Bedroom
It's your bedroom. It's not very interesting. The hall is to the East. The side door (closed) leads out of the house to the West. 

You've just gotten out of your bed, having woken up from a nap.

On the nightstand is an iPod.

>open door
You open the Side Door.

* * *

>w
The Garden
A small garden. There are a few different kinds of flowers and a few different kinds of squash. It's a peaceful place. A spigot on the wall sits above a circular indent in the dirt. You could swear there used to be a bucket somewhere around here, but you don't see it anywhere...

The side door to your house is East, and a path leads off towards town to the West.

You can see the shed (closed) here.

>w
Outskirts of Town
There's less town here than there is to the South. The garden is East. The space center is North. The road is West.

>n
Space Center
Your friendly neighborhood space center. They build rockets and stuff. The outskirts of town are South, the launch pad is North.

* * *

>n
Launch Pad
The place where rockets take off from. The rest of the Space Center is South.

You can see a spaceship here.

>open door
You open the spaceship, revealing an ON button, a LAUNCH button, a spacesuit and a helmet.

>get in ship
You get into the spaceship.

In the spaceship you can see an ON button, a LAUNCH button, a spacesuit and a helmet.

>press on
You press the ON button. All around you dials spin and lights blink.

A dialog appears on the screen: WARNING: LOW FUEL. SAY "confirm" to continue. Mission abort HIGHLY recommended.

>close door
You close the spaceship.

>press launch
The computer counts down: "3... 2... 1... LAUNCHING". 

 The world around you starts to disappear into the smoke emmitted from the rocket engine. You feel yourself pressed into the seat as the spaceship lifts off toward the sky. 

The computer says "This ship is equipped with an auto spacesuit. Simply say SUIT UP and the ship will automatically put your space suit on you so you can go out into space."

* * *

>n
Launch Pad
The place where rockets take off from. The rest of the Space Center is South.

You can see a spaceship here.

>open ship
You open the spaceship, revealing an ON button, a LAUNCH button, a spacesuit and a helmet.

>confirm
Nothing happens.

>out
But you aren't in anything at the moment.

>s
Space Center
Your friendly neighborhood space center. They build rockets and stuff. The outskirts of town are South, the launch pad is North.

>confirm
That doesn't make sense here.

>n
Launch Pad
The place where rockets take off from. The rest of the Space Center is South.

You can see a spaceship here.

>confirm
Nothing happens.

>in
You can't go that way.

>x spaceship
A very small rocket. Just big enough to carry one person to space.

In the spaceship are an ON button, a LAUNCH button, a spacesuit and a helmet.

>confirm
Nothing happens.

>push on
You can't do that without being in the ship.

>enter ship
You get into the spaceship.

In the spaceship you can see an ON button, a LAUNCH button, a spacesuit and a helmet.

>push on
You press the ON button. All around you dials spin and lights blink.

A dialog appears on the screen: WARNING: LOW FUEL. SAY "confirm" to continue. Mission abort HIGHLY recommended.

>out
You get out of the spaceship.

Launch Pad
The place where rockets take off from. The rest of the Space Center is South.

You can see a spaceship here.

>confirm
The dialog on the screen goes away. The screen now reads READY FOR LAUNCH.

>push launch
Launching with the door open seems like an extraordinarily bad idea, even for yourself.

>say cancel
(to yourself)
There is no reply.

>cancel
Nothing happens.

* * *

Welcome to Unsafe. If you're not sure what to do, type "help".

Bedroom
It's your bedroom. It's not very interesting. The hall is to the East. The side door (closed) leads out of the house to the West. 

You've just gotten out of your bed, having woken up from a nap.

On the nightstand is an iPod.

>plugh
A hollow voice says, "This puzzle was brought to you by plugh (pronounced ✈✈✈ Galactic Trendsetters ✈✈✈)."

>xyzzy
A hollow voice says, "Insert red herring here."

>sing
That's not a verb I recognise.

* * *

Welcome to Unsafe. If you're not sure what to do, type "help".

Bedroom
It's your bedroom. It's not very interesting. The hall is to the East. The side door (closed) leads out of the house to the West. 

You've just gotten out of your bed, having woken up from a nap.

On the nightstand is an iPod.

>suit up
That doesn't make sense here.

>undo
Bedroom
[Previous turn undone.]

* * *

I beg your pardon?

>w
The Garden
A small garden. There are a few different kinds of flowers and a few different kinds of squash. It's a peaceful place. A spigot on the wall sits above a circular indent in the dirt. You could swear there used to be a bucket somewhere around here, but you don't see it anywhere...

The side door to your house is East, and a path leads off towards town to the West.

You can see the shed (closed) here.

* * *

>open ship
You open the spaceship, revealing an ON button, a LAUNCH button, a spacesuit and a helmet.

>suit up
The spaceship's machinery puts a space suit on you faster than you could possibly have done it yourself.

>undo
Launch Pad
[Previous turn undone.]

>say suit up
(to yourself)
There is no reply.

>undo
Launch Pad
[Previous turn undone.]

>say suit up to computer
The spaceship's machinery puts a space suit on you faster than you could possibly have done it yourself.

>s
Space Center
Your friendly neighborhood space center. They build rockets and stuff. The outskirts of town are South, the launch pad is North.

>i
You are carrying:
  a helmet (being worn)
  a spacesuit (being worn)
  pants (being worn)
  underwear (being worn)
  socks (being worn)
  a shirt (being worn)
  work shoes (being worn)
  a belt (being worn)
  a hat (being worn)
  a jacket (being worn)

>s
Outskirts of Town
There's less town here than there is to the South. The garden is East. The space center is North. The road is West.

>s
Town Square
The Town Square stretches out in front of you. There are 10 or 20 unremarkable buildings that you couldn't care less about. South of you is the Mad Scientist's House. West, a hole in the wall leads into the Abandoned Warehouse. North of here, the town thins out.

You can see the Mad Scientist's Grand Entrance here.

>enter entrance
You can't go through the Mad Scientist's Grand Entrance because it's closed.

>open entrance
You open the Mad Scientist's Grand Entrance.

I beg your pardon?

>s
Mad Scientist's House
A house filled with so many useless gadgets the like of which you've never seen. There are tubes, filling two thirds of the room. High up on the wall there is a shelf. Taking up one entire wall of the room is an enormous amplifier.

On the high-up shelf are a small tool box (closed) and a bottle of soylent.

You can also see the Mad Scientist's Grand Entrance and a ladder here.

>open box
You can't reach the shelf.

>up
Mad Science Laboratory
A room full of so much mad science, it makes you mad just to think about it. The wall is covered in chalkboards, and the chalkboards are covered in diagrams, and the diagrams are covered in labels. Maddening.

You can see a ladder, a time machine and a time safe (closed) here.

>up
You can't go that way.

>down
Mad Scientist's House
A house filled with so many useless gadgets the like of which you've never seen. There are tubes, filling two thirds of the room. High up on the wall there is a shelf. Taking up one entire wall of the room is an enormous amplifier.

On the high-up shelf are a small tool box (closed) and a bottle of soylent.

You can also see a ladder and the Mad Scientist's Grand Entrance here.

>take ladder
That's fixed in place.

>x shelf
A high-up shelf that you imagine stores the mad scientist's secrets.  It's so high up that you can't see on it.

On the high-up shelf are a small tool box (closed) and a bottle of soylent.

>n
Town Square
The Town Square stretches out in front of you. There are 10 or 20 unremarkable buildings that you couldn't care less about. South of you is the Mad Scientist's House. West, a hole in the wall leads into the Abandoned Warehouse. North of here, the town thins out.

You can see the Mad Scientist's Grand Entrance here.

>e
You can't go that way.

>n
Outskirts of Town
There's less town here than there is to the South. The garden is East. The space center is North. The road is West.

>e
The Garden
A small garden. There are a few different kinds of flowers and a few different kinds of squash. It's a peaceful place. A spigot on the wall sits above a circular indent in the dirt. You could swear there used to be a bucket somewhere around here, but you don't see it anywhere...

The side door to your house is East, and a path leads off towards town to the West.

You can see the shed (closed) here.

>e
Bedroom
It's your bedroom. It's not very interesting. The hall is to the East. The side door (open) leads out of the house to the West. 

On the nightstand is an iPod.

>e
Hall
The hall in the middle of your house. Your bedroom is to the West. The staircase leading upwards is to the North. The back entryway is to the South. The kitchen is to the East. You can also go down to the basement from here.

There is a muddy brown key hanging from a hook on the wall.

* * *

>w
Hall
The hall in the middle of your house. Your bedroom is to the West. The staircase leading upwards is to the North. The back entryway is to the South. The kitchen is to the East. You can also go down to the basement from here.

There is a muddy brown key hanging from a hook on the wall.

>w
Bedroom
It's your bedroom. It's not very interesting. The hall is to the East. The side door (open) leads out of the house to the West. 

On the nightstand is an iPod.

>w
The Garden
A small garden. There are a few different kinds of flowers and a few different kinds of squash. It's a peaceful place. A spigot on the wall sits above a circular indent in the dirt. You could swear there used to be a bucket somewhere around here, but you don't see it anywhere...

The side door to your house is East, and a path leads off towards town to the West.

You can see the shed (closed) here.

* * *

>w
Outskirts of Town
There's less town here than there is to the South. The garden is East. The space center is North. The road is West.

>s
Town Square
The Town Square stretches out in front of you. There are 10 or 20 unremarkable buildings that you couldn't care less about. South of you is the Mad Scientist's House. West, a hole in the wall leads into the Abandoned Warehouse. North of here, the town thins out.

You can see the Mad Scientist's Grand Entrance here.

>s
Mad Scientist's House
A house filled with so many useless gadgets the like of which you've never seen. There are tubes, filling two thirds of the room. High up on the wall there is a shelf. Taking up one entire wall of the room is an enormous amplifier.

On the high-up shelf are a small tool box (closed) and a bottle of soylent.

You can also see the Mad Scientist's Grand Entrance and a ladder here.

>drop stool
Dropped.

* * *

>get on stool
You get onto the stool.

>take box
Taken.

>take soylent
Taken.

>drink soylent
You could get used to this mad scientist lifestyle - that soylent is truly delectable.

>x soylent
You can't see any such thing.

>eat soylent
You can't see any such thing.

>undo
Mad Scientist's House
[Previous turn undone.]

>i
You are carrying:
  a small tool box (closed)
  a helmet (being worn)
  a spacesuit (being worn)
  pants (being worn)
  underwear (being worn)
  socks (being worn)
  a shirt (being worn)
  work shoes (being worn)
  a belt (being worn)
  a hat (being worn)
  a jacket (being worn)

>x soylent
You can't see any such thing.

>l
Mad Scientist's House (on the stool)
A house filled with so many useless gadgets the like of which you've never seen. There are tubes, filling two thirds of the room. High up on the wall there is a shelf. Taking up one entire wall of the room is an enormous amplifier.

You can see the Mad Scientist's Grand Entrance and a ladder here.

>x shelf
A high-up shelf that you imagine stores the mad scientist's secrets.  On the tool shelf, you can see nothing. That's disappointing.

>x shelf
A high-up shelf that you imagine stores the mad scientist's secrets.  On the tool shelf, you can see nothing. That's disappointing.

>i
You are carrying:
  a small tool box (closed)
  a helmet (being worn)
  a spacesuit (being worn)
  pants (being worn)
  underwear (being worn)
  socks (being worn)
  a shirt (being worn)
  work shoes (being worn)
  a belt (being worn)
  a hat (being worn)
  a jacket (being worn)

>x box
You see nothing special about the small tool box.

>pen box
That's not a verb I recognise.

>open box
You open the small tool box, revealing Super glue.

>x glue
A tube of super glue. It has a warning: EXTREMELY STICKY. Unfortunately, the cap seems to be super glued on, so it's not going to be much use to you.

>eat glue
That doesn't look very edible right now. Maybe if there were an opening and you could actually squeeze it into your mouth?

>w
(first getting off the stool)
You can't go that way.

>n
Town Square
The Town Square stretches out in front of you. There are 10 or 20 unremarkable buildings that you couldn't care less about. South of you is the Mad Scientist's House. West, a hole in the wall leads into the Abandoned Warehouse. North of here, the town thins out.

You can see the Mad Scientist's Grand Entrance here.

>w
Abandoned Warehouse
The warehouse is old and abandoned. It is big and extends South. Not much more to say. The Road is to the North. The Tunnel of Extraction is below. There are holes in the wall to the East and West.

You can see The Tunnel of Extraction here.

>w
Clearing
It's very clear here. The edge of the woods is to the West. A hole that leads into the abandoned warehouse is to the East. There's a stream to the North.

>w
Edge of the Woods
The woods start here and extend to the West. There's a clearing to the East.

>w
As you walk into the woods, a large grizzly bear shows up, baring (bear-ing?) its teeth at you. You hastily take three steps back.
The bear seems to be guarding the entrance to the woods. Seems like it would be awfully difficult to get through here unless the bear were somehow distracted. With food, maybe?

>w
You're too scared of the bear to go there. You might be able to distract the bear with something it likes eating, though.

>e
Clearing
It's very clear here. The edge of the woods is to the West. A hole that leads into the abandoned warehouse is to the East. There's a stream to the North.

>e
Abandoned Warehouse
The warehouse is old and abandoned. It is big and extends South. Not much more to say. The Road is to the North. The Tunnel of Extraction is below. There are holes in the wall to the East and West.

You can see The Tunnel of Extraction here.

I beg your pardon?

>e
Town Square
The Town Square stretches out in front of you. There are 10 or 20 unremarkable buildings that you couldn't care less about. South of you is the Mad Scientist's House. West, a hole in the wall leads into the Abandoned Warehouse. North of here, the town thins out.

You can see the Mad Scientist's Grand Entrance here.

>cancel
That doesn't make sense here.

>n
Outskirts of Town
There's less town here than there is to the South. The garden is East. The space center is North. The road is West.

>n
Space Center
Your friendly neighborhood space center. They build rockets and stuff. The outskirts of town are South, the launch pad is North.

* * *

>n
Launch Pad
The place where rockets take off from. The rest of the Space Center is South.

You can see a spaceship here.

>enter
You get into the spaceship.

In the spaceship you can see an ON button and a LAUNCH button.

>cancel
Nothing happens.

>ls
That's not a verb I recognise.

>push on
You press the ON button. All around you dials spin and lights blink.

A dialog appears on the screen: WARNING: LOW FUEL. SAY "confirm" to continue. Mission abort HIGHLY recommended.

>push on
The spaceship is already on, you're not confident about what pressing that again would do so you're not gonna do it.

>push on
The spaceship is already on, you're not confident about what pressing that again would do so you're not gonna do it.

>push launch
Launching with the door open seems like an extraordinarily bad idea, even for yourself.

>close door
You close the spaceship.

>ush launch
That's not a verb I recognise.

>push launch
The warning about fuel flashes angrily at you. It's expecting a response.

>confirmm
That's not a verb I recognise.

>confirm
That's not a verb I recognise.

>confirm
That's not a verb I recognise.

* * *

>suit up
That doesn't make sense here.

>what
That's not a verb I recognise.

* * *

Welcome to Unsafe. If you're not sure what to do, type "help".

Bedroom
It's your bedroom. It's not very interesting. The hall is to the East. The side door (closed) leads out of the house to the West. 

You've just gotten out of your bed, having woken up from a nap.

On the nightstand is an iPod.

>take ipod
Taken.

>play ipod
You try playing a song but you think the speaker in the iPod is broken. Maybe you need to plug in headphones or something?

>i
You are carrying:
  an iPod
  pants (being worn)
  underwear (being worn)
  socks (being worn)
  a shirt (being worn)
  work shoes (being worn)
  a belt (being worn)
  a hat (being worn)
  a jacket (being worn)

>x ipod
It's an iPod touch, third-generation, maybe?

>push play
Nothing obvious happens.

>e
Hall
The hall in the middle of your house. Your bedroom is to the West. The staircase leading upwards is to the North. The back entryway is to the South. The kitchen is to the East. You can also go down to the basement from here.

There is a muddy brown key hanging from a hook on the wall.

* * *

>w
Hall
The hall in the middle of your house. Your bedroom is to the West. The staircase leading upwards is to the North. The back entryway is to the South. The kitchen is to the East. You can also go down to the basement from here.

There is a muddy brown key hanging from a hook on the wall.

>u
Upstairs Hall
The second floor of your house. Stairs lead down. The study is West, and the bathroom is East.

You can see a left running shoe here.

* * *

>w
Study
Where you study. The hall is East.

On the desk are a dime and a quarter.

You can also see the closet door here.

>open door
That's already open.

>x closet
You look into the closet. There's a chest of drawers in there.

>e
Upstairs Hall
The second floor of your house. Stairs lead down. The study is West, and the bathroom is East.

You can see a left running shoe here.

>e
Bathroom
It's just a bathroom. The Upstairs Hall is West.

You can see a mirror, a medicine cabinet (closed) and a bathtub (empty) here.

>open cabinet
You're not tall enough to reach the medicine cabinet. Drat!

>w
Upstairs Hall
The second floor of your house. Stairs lead down. The study is West, and the bathroom is East.

You can see a left running shoe here.

>s
You can't go that way.

* * *

>u
Hall
The hall in the middle of your house. Your bedroom is to the West. The staircase leading upwards is to the North. The back entryway is to the South. The kitchen is to the East. You can also go down to the basement from here.

There is a muddy brown key hanging from a hook on the wall.

>u
Upstairs Hall
The second floor of your house. Stairs lead down. The study is West, and the bathroom is East.

You can see a left running shoe here.

* * *

>w
Study
Where you study. The hall is East.

On the desk are a dime and a quarter.

You can also see the closet door here.

>e
Upstairs Hall
The second floor of your house. Stairs lead down. The study is West, and the bathroom is East.

You can see a left running shoe here.

* * *

>e
Bathroom
It's just a bathroom. The Upstairs Hall is West.

You can see a mirror, a medicine cabinet (closed) and a bathtub (empty) here.

>w
Upstairs Hall
The second floor of your house. Stairs lead down. The study is West, and the bathroom is East.

You can see a left running shoe here.

>w
Study
Where you study. The hall is East.

On the desk are a dime and a quarter.

You can also see the closet door here.

* * *

>x closet
You look into the closet. There's a chest of drawers in there.

>open drawers
You can't see any such thing.

* * *

>open chest
You can't see any such thing.

>x chest
You can't see any such thing.

>x drawers
You can't see any such thing.

>enter closet
The Closet
A small room. The study is South.

You can see the closet door and a chest of drawers here.

>x drawers
You can't use multiple objects with that verb.

>open drawer
Which do you mean, the first drawer, the second drawer, the third drawer, the fourth drawer or the fifth drawer?

>open first
You open the first drawer, revealing a quarter.

>open second
You open the second drawer, revealing a quarter.

>open third
You open the third drawer, revealing a quarter.

>open fourth
You open the fourth drawer, revealing a quarter.

>open fifth
That's already open.

>l
The Closet
A small room. The study is South.

You can see the closet door and a chest of drawers here.

>x fifth
In the fifth drawer is a quarter.

>l
The Closet
A small room. The study is South.

You can see the closet door and a chest of drawers here.

>x chest
It's an old wooden chest with 5 drawers. The top drawer is open. The second drawer is open. The third drawer is open. The fourth drawer is open. The bottom drawer is open.

>l
The Closet
A small room. The study is South.

You can see the closet door and a chest of drawers here.

>s
Study
Where you study. The hall is East.

On the desk are a dime and a quarter.

You can also see the closet door here.

>x desk
(the desk)
It's a sturdy wooden desk. There's a drawer.

On the desk are a dime and a quarter.

>i
You are carrying:
  an iPod
  pants (being worn)
  underwear (being worn)
  socks (being worn)
  a shirt (being worn)
  work shoes (being worn)
  a belt (being worn)
  a hat (being worn)
  a jacket (being worn)

>open drawer
You open the desk drawer, revealing earbuds.

>take earbuds
Taken.

>plug earbuds
You plug the earbuds into the iPod. Your favorite song starts to play through them!

>wear earbuds
You put on earbuds.

>i
You are carrying:
  earbuds (being worn)
  an iPod
  pants (being worn)
  underwear (being worn)
  socks (being worn)
  a shirt (being worn)
  work shoes (being worn)
  a belt (being worn)
  a hat (being worn)
  a jacket (being worn)

>listen
Your favorite song! It's cute and dumb and it's about death.

>x ipod
It's an iPod touch, third-generation, maybe? It's playing your favorite song.

>e
Upstairs Hall
The second floor of your house. Stairs lead down. The study is West, and the bathroom is East.

You can see a left running shoe here.

The iPod has stopped playing its song. Maybe it ran out of battery.

>x ipod
It's an iPod touch, third-generation, maybe?

* * *

>push play
Nothing obvious happens.

>i
You are carrying:
  earbuds (being worn)
  an iPod
  pants (being worn)
  underwear (being worn)
  socks (being worn)
  a shirt (being worn)
  work shoes (being worn)
  a belt (being worn)
  a hat (being worn)
  a jacket (being worn)

>restart
Are you sure you want to restart?

>y
Unsafe
An Interactive Fiction by Brian Chen and Jakob Weisblat
Release 8 / Serial number 190311 / Inform 7 build 6M62 (I6/v6.33 lib 6/12N) SD

Bedroom
It's your bedroom. It's not very interesting. The hall is to the East. The side door (closed) leads out of the house to the West. 

You've just gotten out of your bed, having woken up from a nap.

On the nightstand is an iPod.

>take ipod
Taken.

* * *

>wear earbuds
You put on earbuds.

>plug earbuds
You plug the earbuds into the iPod. Your favorite song starts to play through them!

>i
You are carrying:
  earbuds (being worn)
  an iPod
  pants (being worn)
  underwear (being worn)
  socks (being worn)
  a shirt (being worn)
  work shoes (being worn)
  a belt (being worn)
  a hat (being worn)
  a jacket (being worn)

* * *

>undo
Further Along the Road
[Previous turn undone.]

>undo
Further Along the Road
[Previous turn undone.]

>[39] n
The boom gates are closing, it looks like a train is coming. You probably shouldn't go to the train station right now.

>undo
Further Along the Road
[Previous turn undone.]

>undo
Parking Lot
[Previous turn undone.]

>[38] n
You can't go that way.

>[39] n
You can't go that way.

* * *

>undo
Woods
[Previous turn undone.]

I beg your pardon?

>listen
You can hear the buzzing of wasps. They seem to be coming from the ash tree.

>climb ash tree
Lower Branches of Ash Tree
You're a bit off the ground in the ash tree.

* * *

>unso
Please give one of the answers above.

Would you like to RESTART, RESTORE a saved game, QUIT or UNDO the last command?

>unso
Please give one of the answers above.

Would you like to RESTART, RESTORE a saved game, QUIT or UNDO the last command?

>undo
Woods
[Previous turn undone.]

>kill bear with knife
I only understood you as far as wanting to kill the grizzly bear.

>kill bear
You take your stick and poke the bear. It wakes up and promptly eats you.

You've reached one of this game's 14 endings! In that game you used 24 moves. The optimal number of moves is 24.
Great job, you got the optimal number of moves!

    *** You have died ***

Would you like to RESTART, RESTORE a saved game, QUIT or UNDO the last command?

>undo
Woods
[Previous turn undone.]

>e
Edge of the Woods
The woods start here and extend to the west. There's a clearing to the east.

* * *

>n
Outskirts of Town
There's less town here than there is to the South. The garden is east. The space center is North. The road is West.

>e
The Garden
A small garden. There are a few different kinds of flowers and a few different kinds of squash. It's a peaceful place. A spigot on the wall sits above a circular indent in the dirt. You could swear there used to be a bucket somewhere around here, but you don't see it anywhere...

You can see the shed (closed) here.

>e
You can't go through the Side Door because it's closed.

>open dopor
You can't see any such thing.

>e
You can't go through the Side Door because it's closed.

>d
You can't go that way.

>w
Outskirts of Town
There's less town here than there is to the South. The garden is east. The space center is North. The road is West.

* * *

>w
By the Stream
There's a stream, making whatever sound water makes. There's also a scary warning sign. The road is to the east, and the clearing is to the south.

>d
You can't go that way.

>s
Clearing
It's very clear here. The edge of the woods is to the west. A hole that leads into the abandoned warehouse is to the east. There's a stream to the north.

>e
Abandoned Warehouse
The warehouse is old and abandoned. It is big and extends south. Not much more to say. The Road is to the North. The Tunnel of Extraction is below. There are holes in the wall to the East and West.

You can see The Tunnel of Extraction here.

>d
This tunnel was pretty spooky the first time you went through it. You take a second to mentally prepare yourself before going through again.

>open vat
You can't see any such thing.

>d
You go through the long and winding Tunnel of Extraction.

Basement
The dark basement of your house. The hall is upstairs. The Tunnel of Extraction is to the west.

You can see The Tunnel of Extraction, a vat (closed) and a key cabinet (in which is a small metal key) here.

>open vat
You lift the large plastic lid off of the vat, revealing the pungent rocket fuel beneath.

>eat fuel
That's plainly inedible.

* * *

>restart
Welcome to Unsafe. If you're not sure what to do, type "help".

Bedroom
It's your bedroom. It's not very interesting. The hall is to the East. The side door (closed) leads out of the house to the West. 

You've just gotten out of your bed, having woken up from a nap.

On the nightstand is an iPod.

>e
Hall
The hall in the middle of your house. Your bedroom is to the West. The staircase leading upwards is to the North. The back entryway is to the South. The kitchen is to the East. You can also go down to the basement from here.

There is a muddy brown key hanging from a hook on the wall.

* * *

>open fridge
You open the refrigerator, revealing a fish and a pie.

>get fish
Taken.

>w
Hall
The hall in the middle of your house. Your bedroom is to the West. The staircase leading upwards is to the North. The back entryway is to the South. The kitchen is to the East. You can also go down to the basement from here.

There is a muddy brown key hanging from a hook on the wall.

>s
Back Entryway
The back entryway to your house. It's a tiny room with a coat rack and a trash can being the most notable scenery. There is a Toyota key tied to the coat rack. The hall is to the North, the backyard to the South.

You can see the back door, a blue key, a right running shoe and a Toyota key here.

>unlock back door with blue key
You need to take the key before you can do that.

>unlock back door with muddy
You can't see any such thing.

>e
You can't go that way.

>w
You can't go that way.

>s
You can't go through the back door because it's closed.

>open door
It seems to be locked.

>open door with key
Which do you mean, the blue key or the Toyota key?

>open door with toyota key
(first taking the Toyota key)
The Toyota key is tied to the coat rack; you should untie it before you take it.

>restart
Are you sure you want to restart?

* * *

>undo
A Spooky Lair
[Previous turn undone.]

>undo
A Spooky Lair
[Previous turn undone.]

>[22] lock cage with small key
First you would have to close the cage.

>undo
A Spooky Lair
[Previous turn undone.]

>take cage
Taken.

>put mouse in cage
You can't see any such thing.

>i
You are carrying:
  a cage (open)
    Charlie
  a jar (open but empty)
  a small metal key
  a muddy brown key
  pants (being worn)
  underwear (being worn)
  socks (being worn)
  a shirt (being worn)
  work shoes (being worn)
  a belt (being worn)
  a hat (being worn)
  a jacket (being worn)

The snake slithers out of the cage with remarkable speed.

>take jar
Taken.

>open jar
You open the jar, revealing a mouse.

>take mouse
Taken.

>put mouse in cage
You try to put the mouse in the cage while holding both of them, but in the end you drop the cage and the mouse scurries off. Oh well, maybe there are more mice.

* * *

>restart
Unsafe
An Interactive Fiction by Brian Chen and Jakob Weisblat
Release 3 / Serial number 190228 / Inform 7 build 6M62 (I6/v6.33 lib 6/12N) SD

Bedroom
It's your bedroom. It's not very interesting. The hall is to the east. The side door (closed) leads out of the house to the West. 

You've just gotten out of your bed, having woken up from a nap.

On the nightstand is an iPod.

>test fork
>--> The following tests are available:
'test all'
'test platform'
'test toaster'
'test fly'
'test space'
'test car'
'test running'
'test candle'
'test cage'
'test piranhas'
'test trees'
'test treetops'
'test moose'
'test time-machine'
'test bear'
'test glue'
'test pie'

* * *

>undo
A Spooky Lair
[Previous turn undone.]

>x snake
It's a rattlesnake. They say rattlesnakes are dangerous, but you've always thought that was silly.

The snake slithers out of the cage with remarkable speed, slamming the door open as it goes. Maybe you should lock it next time.

>take snake
I don't suppose Bob would care for that.

* * *

Please give one of the answers above.

Would you like to RESTART, RESTORE a saved game, QUIT or UNDO the last command?

>restart
Unsafe
An Interactive Fiction by Brian Chen and Jakob Weisblat
Release 3 / Serial number 190226 / Inform 7 build 6M62 (I6/v6.33 lib 6/12N) SD

Bedroom
It's your bedroom. It's not very interesting. The hall is to the east. The side door (closed) leads out of the house to the West. 

You're lying in your bed, just having woken up from a nap.

On the nightstand is an iPod.

* * *

>restart
Unsafe
An Interactive Fiction by Brian Chen and Jakob Weisblat
Release 3 / Serial number 190226 / Inform 7 build 6M62 (I6/v6.33 lib 6/12N) SD

Bedroom
It's your bedroom. It's not very interesting. The hall is to the east. The side door (closed) leads out of the house to the West. 

You're lying in your bed, just having woken up from a nap.

On the nightstand is an iPod.

* * *

>undo
A Spooky Lair
[Previous turn undone.]

>undo
Abandoned Warehouse
[Previous turn undone.]

>[17] get candle
You can't see any such thing.

>x snake
You can't see any such thing.

>l
Abandoned Warehouse
The warehouse is old and abandoned. It is big and extends South. Not much more to say. The Road is to the North. The Tunnel of Extraction is below. There are holes in the wall to the East and West.

You can see The Tunnel of Extraction here.

>s
A Spooky Lair
A lair in which a demonic ritual might be held. There is a table with a pentagram drawn on it. It's the South end of the warehouse; the only exit is North, to the rest of the warehouse.

On the table are a candle and a sacrificial knife.

You can also see four snakes and an ancient cabinet (closed) here.

You feel drawn toward the candle, as though its destiny and yours are intertwined.

>l
A Spooky Lair
A lair in which a demonic ritual might be held. There is a table with a pentagram drawn on it. It's the South end of the warehouse; the only exit is North, to the rest of the warehouse.

On the table are a candle and a sacrificial knife.

You can also see four snakes and an ancient cabinet (closed) here.

>x snake
You can't see any such thing.

* * *

>restart
Unsafe
An Interactive Fiction by Brian Chen and Jakob Weisblat
Release 7 / Serial number 190228 / Inform 7 build 6M62 (I6/v6.33 lib 6/12N) SD

Bedroom
It's your bedroom. It's not very interesting. The hall is to the East. The side door (closed) leads out of the house to the West. 

You've just gotten out of your bed, having woken up from a nap.

On the nightstand is an iPod.

* * *

>undo
Abandoned Train Station
[Previous turn undone.]

>go to edge
You can't see any such thing.

>go edge
You get onto the edge of the platform.

A train enters the station while you're jamming to the music, and you trip and fall into the train tracks in front of it. That was really dumb.

You've reached one of this game's 14 endings! In that game you used 37 moves. The optimal number of moves is 37.
Great job, you got the optimal number of moves!

    *** You have died ***

Would you like to RESTART, RESTORE a saved game, QUIT or UNDO the last command?

>undo
Abandoned Train Station
[Previous turn undone.]

>stand on edge
You get onto the edge of the platform.

A train enters the station while you're jamming to the music, and you trip and fall into the train tracks in front of it. That was really dumb.

You've reached one of this game's 14 endings! In that game you used 37 moves. The optimal number of moves is 37.
Great job, you got the optimal number of moves!

    *** You have died ***

Would you like to RESTART, RESTORE a saved game, QUIT or UNDO the last command?

>undo
Abandoned Train Station
[Previous turn undone.]

>run across tracks
You're gonna run wearing these shoes???? You'd break your back.

>go tracks
As you start to climb down, you see the train coming in the distance and you think better of it.

>run tracks
As you start to climb down, you see the train coming in the distance and you think better of it.

* * *

>restart
Unsafe
An Interactive Fiction by Brian Chen and Jakob Weisblat
Release 8 / Serial number 190311 / Inform 7 build 6M62 (I6/v6.33 lib 6/12N) SD

Bedroom
It's your bedroom. It's not very interesting. The hall is to the East. The side door (closed) leads out of the house to the West. 

You've just gotten out of your bed, having woken up from a nap.

On the nightstand is an iPod.

>take iPod
Taken.

>e
Hall
The hall in the middle of your house. Your bedroom is to the West. The staircase leading upwards is to the North. The back entryway is to the South. The kitchen is to the East. You can also go down to the basement from here.

There is a muddy brown key hanging from a hook on the wall.

* * *

>take earbuds
Taken.

>put on earbuds
You put on earbuds.

>rules
Rules tracing now switched on. Type "rules off" to switch it off again, or "rules all" to include even rules which do not apply.

* * *

>i
[Rule "declare everything initially unmentioned rule" applies.]
[Rule "announce items from multiple object lists rule" applies.]
[Rule "set pronouns from items from multiple object lists rule" applies.]
[Rule "before stage rule" applies.]
[Rule "instead stage rule" applies.]
[Rule "investigate player's awareness before action rule" applies.]
[Rule "player aware of his own actions rule" applies.]
[Rule "check stage rule" applies.]
[Rule "carry out stage rule" applies.]
[Rule "print empty inventory rule" applies.]
[Rule "print standard inventory rule" applies.]
You are carrying:
  earbuds (being worn)
  an iPod
  pants (being worn)
  underwear (being worn)
  socks (being worn)
  a shirt (being worn)
  work shoes (being worn)
  a belt (being worn)
  a hat (being worn)
  a jacket (being worn)
[Rule "after stage rule" applies.]

[Rule "investigate player's awareness after action rule" applies.]
[Rule "report stage rule" applies.]
[Rule "report other people taking inventory rule" applies.]
[Rule "last specific action-processing rule" applies.]
[Rule "A first turn sequence rule" applies.]
[Rule "every turn stage rule" applies.]
[Rule "Every turn" applies.]
[Rule "A last turn sequence rule" applies.]
[Rule "notify score changes rule" applies.]

>restart
[Rule "declare everything initially unmentioned rule" applies.]
[Rule "investigate player's awareness before action rule" applies.]
[Rule "player aware of his own actions rule" applies.]
[Rule "check stage rule" applies.]
[Rule "carry out stage rule" applies.]
Are you sure you want to restart?

>y
Unsafe
An Interactive Fiction by Brian Chen and Jakob Weisblat
Release 8 / Serial number 190311 / Inform 7 build 6M62 (I6/v6.33 lib 6/12N) SD

Bedroom
It's your bedroom. It's not very interesting. The hall is to the East. The side door (closed) leads out of the house to the West. 

You've just gotten out of your bed, having woken up from a nap.

On the nightstand is an iPod.

>l
Bedroom
It's your bedroom. It's not very interesting. The hall is to the East. The side door (closed) leads out of the house to the West. 

On the nightstand is an iPod.

* * *

>restart
Unsafe
An Interactive Fiction by Brian Chen and Jakob Weisblat
Release 3 / Serial number 190227 / Inform 7 build 6M62 (I6/v6.33 lib 6/12N) SD

Bedroom
It's your bedroom. It's not very interesting. The hall is to the east. The side door (closed) leads out of the house to the West. 

You've just gotten out of your bed, having woken up from a nap.

On the nightstand is an iPod.

>n
You can't go that way.

>s
You can't go that way.

>w
You can't go through the Side Door because it's closed.

>open side
You open the Side Door.

>w
The Garden
A small garden. There are a few different kinds of flowers and a few different kinds of squash. It's a peaceful place. A spigot on the wall sits above a circular indent in the dirt.

You can see the shed (closed) here.

* * *

>w
By the Stream
There's a stream, making whatever sound water makes. There's also a scary warning sign. The road is to the east, and the clearing is to the south.

>w
You can't go that way.

>e
Road
It's a road, like what people travel on. The outskirts of town are to the east. To the North you can see a fork in the road. The stream is west. The warehouse is south.

* * *

>n
Further Along the Road
More road! There's a fork in the road here. The main road goes North and South. To the West there's a parking lot.

>n
Abandoned Train Station
No trains.

There are exits to the south and east.

You can see a map here.

>e
Control Room
Where things get controlled. The only exit is to the west.

You can see the CALL TRAIN button here.

>push button
You press the CALL TRAIN button. Nothing happens. Maybe try pressing the button again.

>push button
You press the CALL TRAIN button. Nothing happens. Maybe try pressing the button again.

>push button
Now that you've been standing here for a bit, you notice a sticky note next to the button.
You press the CALL TRAIN button. Nothing happens. Maybe try pressing the button again.

>push button
You press the CALL TRAIN button. Nothing happens. Maybe try pressing the button again.

>push button
You press the CALL TRAIN button. An electronic voice informs you, "The train will be here any minute now." That was easy.

>push button
You press the CALL TRAIN button. An electronic voice informs you, "The train will be here any minute now." That was easy.

I beg your pardon?

>l
Control Room
Where things get controlled. The only exit is to the west.

You can see the CALL TRAIN button here.

>x note
A big yellow button labelled CALL TRAIN. Next to the button is a handwritten note reading "This button doesn't work very well. Sometimes you have to press it ten or twenty times to get it to work.".

>l
Control Room
Where things get controlled. The only exit is to the west.

You can see the CALL TRAIN button here.

>e
You can't go that way.

>w
Abandoned Train Station
No trains.

There are exits to the south and east.

You can see a map here.

>w
You can't go that way.

>s
Further Along the Road
More road! There's a fork in the road here. The main road goes North and South. To the West there's a parking lot.

>s
Road
It's a road, like what people travel on. The outskirts of town are to the east. To the North you can see a fork in the road. The stream is west. The warehouse is south.

* * *

>s
Abandoned Warehouse
The warehouse is old and abandoned. It is big and extends south. Not much more to say. The Road is to the North. The Tunnel of Extraction is below. There are holes in the wall to the East and West.

You can see The Tunnel of Extraction here.

>s
A Spooky Lair
A lair in which a demonic ritual might be held. There is a table with a pentagram drawn on it. It's the south end of the warehouse; the only exit is north, to the rest of the warehouse.

On the table are a candle and a sacrificial knife.

You can also see four snakes and an ancient cabinet (closed) here.

>s
You can't go that way.

>e
You can't go that way.

* * *

>w
You can't go that way.

>n
Abandoned Warehouse
The warehouse is old and abandoned. It is big and extends south. Not much more to say. The Road is to the North. The Tunnel of Extraction is below. There are holes in the wall to the East and West.

You can see The Tunnel of Extraction here.

>e
Town Square
The Town Square stretches out in front of you. There are 10 or 20 unremarkable buildings that you couldn't care less about. South of you is the Mad Scientist's House. West, a hole in the wall leads into the Abandoned Warehouse. North of here, the town thins out.

You can see the Mad Scientist's Grand Entrance here.

* * *

>e
You can't go that way.

>s
You can't go through the Mad Scientist's Grand Entrance because it's closed.

>open entrance
You open the Mad Scientist's Grand Entrance.

* * *

>s
Mad Scientist's House
A house filled with so many useless gadgets the like of which you've never seen. There are tubes, filling two thirds of the room. High up on the wall there is a shelf. Taking up one entire wall of the room is an enormous amplifier.

On the high-up shelf are a small tool box (closed) and a bottle of soylent.

You can also see the Mad Scientist's Grand Entrance and a ladder here.

>x box
You see nothing special about the small tool box.

>x soylent
A fully nutritional meal replacement. It's made of people.

>take soylent
You can't reach the shelf.

>x box
You see nothing special about the small tool box.

>x amplifier
You see nothing special about the amplifier.

>n
Town Square
The Town Square stretches out in front of you. There are 10 or 20 unremarkable buildings that you couldn't care less about. South of you is the Mad Scientist's House. West, a hole in the wall leads into the Abandoned Warehouse. North of here, the town thins out.

You can see the Mad Scientist's Grand Entrance here.

>n
Outskirts of Town
There's less town here than there is to the South. The garden is east. The space center is North. The road is West.

* * *

>e
The Garden
A small garden. There are a few different kinds of flowers and a few different kinds of squash. It's a peaceful place. A spigot on the wall sits above a circular indent in the dirt.

You can see the shed (closed) here.

>e
Bedroom
It's your bedroom. It's not very interesting. The hall is to the east. The side door (open) leads out of the house to the West. 

On the nightstand is an iPod.

* * *

>e
Hall
The hall in the middle of your house. Your bedroom is to the West. The staircase leading upwards is to the North. The back entryway is to the South. The kitchen is to the East. There is a muddy brown key hanging from a hook on the wall. You can also go down to the basement from here.

You can see a Staircase and a muddy brown key here.

>e
Kitchen
Where food happens. The hall is to the west.

You can see a toaster, a cabinet (closed), a refrigerator (closed) and a stool here.

>e
You can't go that way.

>take all
stool: Taken.

>open cabinet
You open the cabinet, revealing a top drawer, a middle drawer and a bottom drawer.

>l
Kitchen
Where food happens. The hall is to the west.

You can see a toaster, a cabinet (in which are a top drawer (closed), a middle drawer (closed) and a bottom drawer (closed)) and a refrigerator (closed) here.

>ls
That's not a verb I recognise.

>l
Kitchen
Where food happens. The hall is to the west.

You can see a toaster, a cabinet (in which are a top drawer (closed), a middle drawer (closed) and a bottom drawer (closed)) and a refrigerator (closed) here.

>open refrigerator
You open the refrigerator, revealing a fish and a pie.

>ls
That's not a verb I recognise.

I beg your pardon?

>l
Kitchen
Where food happens. The hall is to the west.

You can see a toaster, a cabinet (in which are a top drawer (closed), a middle drawer (closed) and a bottom drawer (closed)) and a refrigerator (in which are a fish and a pie) here.

>take all
fish: One thing at a time!
pie: One thing at a time!

>take fish
Taken.

>take pie
Taken.

>w
Hall
The hall in the middle of your house. Your bedroom is to the West. The staircase leading upwards is to the North. The back entryway is to the South. The kitchen is to the East. There is a muddy brown key hanging from a hook on the wall. You can also go down to the basement from here.

You can see a Staircase and a muddy brown key here.

* * *

>w
Road
It's a road, like what people travel on. The outskirts of town are to the east. To the North you can see a fork in the road. The stream is west. The warehouse is south.

>e
Outskirts of Town
There's less town here than there is to the South. The garden is east. The space center is North. The road is West.

* * *

>e
The Garden
A small garden. There are a few different kinds of flowers and a few different kinds of squash. It's a peaceful place. A spigot on the wall sits above a circular indent in the dirt.

You can see the shed (closed) here.

>take ipod
You can't see any such thing.

>l
The Garden
A small garden. There are a few different kinds of flowers and a few different kinds of squash. It's a peaceful place. A spigot on the wall sits above a circular indent in the dirt.

You can see the shed (closed) here.

>e
Bedroom
It's your bedroom. It's not very interesting. The hall is to the east. The side door (open) leads out of the house to the West. 

On the nightstand is an iPod.

>take ipod
Taken.

>w
The Garden
A small garden. There are a few different kinds of flowers and a few different kinds of squash. It's a peaceful place. A spigot on the wall sits above a circular indent in the dirt.

You can see the shed (closed) here.

* * *

>s
Clearing
It's very clear here. The edge of the woods is to the west. A hole that leads into the abandoned warehouse is to the east. There's a stream to the north.

>s
You can't go that way.

>e
Abandoned Warehouse
The warehouse is old and abandoned. It is big and extends south. Not much more to say. The Road is to the North. The Tunnel of Extraction is below. There are holes in the wall to the East and West.

You can see The Tunnel of Extraction here.

>u
You can't go that way.

>n
Road
It's a road, like what people travel on. The outskirts of town are to the east. To the North you can see a fork in the road. The stream is west. The warehouse is south.

>w
By the Stream
There's a stream, making whatever sound water makes. There's also a scary warning sign. The road is to the east, and the clearing is to the south.

>e
Road
It's a road, like what people travel on. The outskirts of town are to the east. To the North you can see a fork in the road. The stream is west. The warehouse is south.

>w
By the Stream
There's a stream, making whatever sound water makes. There's also a scary warning sign. The road is to the east, and the clearing is to the south.

>n
You can't go that way.

>s
Clearing
It's very clear here. The edge of the woods is to the west. A hole that leads into the abandoned warehouse is to the east. There's a stream to the north.

* * *

>s
You can't go that way.

>w
Edge of the Woods
The woods start here and extend to the west. There's a clearing to the east.

* * *

>e
Clearing
It's very clear here. The edge of the woods is to the west. A hole that leads into the abandoned warehouse is to the east. There's a stream to the north.

>w
Edge of the Woods
The woods start here and extend to the west. There's a clearing to the east.

>w
You're too scared of the bear to go there.

>x bear
You can't see any such thing.

>l
Edge of the Woods
The woods start here and extend to the west. There's a clearing to the east.

>e
Clearing
It's very clear here. The edge of the woods is to the west. A hole that leads into the abandoned warehouse is to the east. There's a stream to the north.

>n
By the Stream
There's a stream, making whatever sound water makes. There's also a scary warning sign. The road is to the east, and the clearing is to the south.

>xyzzy
That's not a verb I recognise.

* * *

>restart
Unsafe
An Interactive Fiction by Brian Chen and Jakob Weisblat
Release 5 / Serial number 190228 / Inform 7 build 6M62 (I6/v6.33 lib 6/12N) SD

Bedroom
It's your bedroom. It's not very interesting. The hall is to the east. The side door (closed) leads out of the house to the West. 

You've just gotten out of your bed, having woken up from a nap.

On the nightstand is an iPod.

* * *

Please give one of the answers above.

Would you like to RESTART, RESTORE a saved game, QUIT or UNDO the last command?

>undo
Bathroom
[Previous turn undone.]

>e
You can't go that way.

The tub overflows and a fair amount of water flows out of the bathtub into the rest of the bathroom.

>d
You can't go that way.

The tub overflows and a fair amount of water flows out of the bathtub into the rest of the bathroom.

>w
You step ouside, but you shiver and decide you need a jacket. You step back inside.

The tub overflows and a fair amount of water flows out of the bathtub into the rest of the bathroom.

>d
You can't go that way.

The tub overflows and a fair amount of water flows out of the bathtub into the rest of the bathroom.

>l
Bathroom
It's just a bathroom.

You can see a mirror, a medicine cabinet (closed) and a bathtub here.

The tub overflows and a fair amount of water flows out of the bathtub into the rest of the bathroom.

>showme house
Which do you mean, the House or the Mad Scientist's House?

>showme the house
Which do you mean, the House or the Mad Scientist's House?

>showme upstairs
Upstairs Hall - room
    Staircase - open door
    left running shoe
singular-named, improper-named; lighted, visited
list grouping key: none
printed name: "Upstairs Hall"
printed plural name: none
indefinite article: "the"
description: "The second floor of your house. Stairs lead down. The study is west, and the bathroom is east."
map region: House

>put on jacket
You put on the jacket.

The tub overflows and a fair amount of water flows out of the bathtub into the rest of the bathroom.

>e
You can't go that way.

The tub overflows and a fair amount of water flows out of the bathtub into the rest of the bathroom.

>w
Upstairs Hall
The second floor of your house. Stairs lead down. The study is west, and the bathroom is east.

You can see a Staircase and a left running shoe here.

>d
Hall
The hall in the middle of your house. Your bedroom is to the West. The staircase leading upwards is to the North. The back entryway is to the South. The kitchen is to the East. There is a muddy brown key hanging from a hook on the wall. You can also go down to the basement from here.

You can see a Staircase and a muddy brown key here.

>e
Kitchen
Where food happens. The hall is to the west.

You can see a toaster, a cabinet (closed) and a refrigerator (closed) here.

>w
Hall
The hall in the middle of your house. Your bedroom is to the West. The staircase leading upwards is to the North. The back entryway is to the South. The kitchen is to the East. There is a muddy brown key hanging from a hook on the wall. You can also go down to the basement from here.

You can see a Staircase and a muddy brown key here.

* * *

>w
Bedroom
It's your bedroom. It's not very interesting. The hall is to the east. The side door (open) leads out of the house to the West. 

On the nightstand is an iPod.

>w
The Garden
A small garden. There are a few different kinds of flowers and a few different kinds of squash. It's a peaceful place. A spigot on the wall sits above a circular indent in the dirt.

You can see a stool and the shed (closed) here.

>restart
Are you sure you want to restart?

>y
Unsafe
An Interactive Fiction by Brian Chen and Jakob Weisblat
Release 5 / Serial number 190228 / Inform 7 build 6M62 (I6/v6.33 lib 6/12N) SD

Bedroom
It's your bedroom. It's not very interesting. The hall is to the east. The side door (closed) leads out of the house to the West. 

You've just gotten out of your bed, having woken up from a nap.

On the nightstand is an iPod.

* * *

>restart
Unsafe
An Interactive Fiction by Brian Chen and Jakob Weisblat
Release 4 / Serial number 190228 / Inform 7 build 6M62 (I6/v6.33 lib 6/12N) SD

Bedroom
It's your bedroom. It's not very interesting. The hall is to the east. The side door (closed) leads out of the house to the West. 

You've just gotten out of your bed, having woken up from a nap.

On the nightstand is an iPod.

>e
Hall
The hall in the middle of your house. Your bedroom is to the West. The staircase leading upwards is to the North. The back entryway is to the South. The kitchen is to the East. There is a muddy brown key hanging from a hook on the wall. You can also go down to the basement from here.

You can see a Staircase and a muddy brown key here.

* * *

>w
You go through the long and winding Tunnel of Extraction.

Abandoned Warehouse
The warehouse is old and abandoned. It is big and extends south. Not much more to say. The Road is to the North. The Tunnel of Extraction is below. There are holes in the wall to the East and West.

You can see The Tunnel of Extraction here.

>d
This tunnel was pretty spooky the first time you went through it. You take a second to mentally prepare yourself before going through again.

>d
Basement
The dark basement of your house. The hall is upstairs. The Tunnel of Extraction is to the west.

You can see The Tunnel of Extraction, a vat (closed) and a key cabinet (in which is a small metal key) here.

* * *

>e
Town Square
The Town Square stretches out in front of you. There are 10 or 20 unremarkable buildings that you couldn't care less about. South of you is the Mad Scientist's House. West, a hole in the wall leads into the Abandoned Warehouse. North of here, the town thins out.

You can see the Mad Scientist's Grand Entrance here.

>w
Abandoned Warehouse
The warehouse is old and abandoned. It is big and extends south. Not much more to say. The Road is to the North. The Tunnel of Extraction is below. There are holes in the wall to the East and West.

You can see The Tunnel of Extraction here.

>d
This tunnel was pretty spooky the first time you went through it. You take a second to mentally prepare yourself before going through again.

>d
You go through the long and winding Tunnel of Extraction.

Basement
The dark basement of your house. The hall is upstairs. The Tunnel of Extraction is to the west.

You can see The Tunnel of Extraction, a vat (closed) and a key cabinet (in which is a small metal key) here.

* * *

>undo
Abandoned Train Station
[Previous turn undone.]

>run
Where do you want to run?

>run tracks
Well that was dumb. You get distracted as you run across the tracks and don't notice the train coming until it's too late.

You've reached one of this game's 14 endings! In that game you used 38 moves. The optimal number of moves is 37.
You can reach this ending more quickly!

    *** You have died ***

Would you like to RESTART, RESTORE a saved game, QUIT or UNDO the last command?

>undo
Abandoned Train Station
[Previous turn undone.]

>w
You're wearing running shoes. These are for running, not just exploring.

>run
Where do you want to run?

>run w
You'd run into a wall!

>run e
You'd run into a wall!

>run n
Well that was dumb. You get distracted as you run across the tracks and don't notice the train coming until it's too late.

You've reached one of this game's 14 endings! In that game you used 40 moves. The optimal number of moves is 37.
You can reach this ending more quickly!

    *** You have died ***

Would you like to RESTART, RESTORE a saved game, QUIT or UNDO the last command?

* * *

>restart
Unsafe
An Interactive Fiction by Brian Chen and Jakob Weisblat
Release 2 / Serial number 190225 / Inform 7 build 6M62 (I6/v6.33 lib 6/12N) SD

Bedroom
It's your bedroom. It's not very interesting. The hall is to the east. The side door (closed) leads out of the house to the West. 

You're lying in your bed, just having woken up from a nap.

On the nightstand is an iPod.

>e
Hall
The hall in the middle of your house. Your bedroom is to the West. The staircase leading upwards is to the North. The back entryway is to the South. The kitchen is to the East. There is a muddy brown key hanging from a hook on the wall. You can also go down to the basement from here.

You can see a Staircase and a muddy brown key here.

>e
Kitchen
You can see a toaster, a cabinet (closed), a refrigerator (closed) and a stool here.

>get stool
Taken.

* * *

>w
Bedroom
It's your bedroom. It's not very interesting. The hall is to the east. The side door (closed) leads out of the house to the West. 

On the nightstand is an iPod.

>open door
You open the Side Door.

* * *

>w
The Garden
A small garden. There are a few different kinds of flowers and a few different kinds of squash. It's a peaceful place. A spigot on the wall sits above a circular indent in the dirt.

You can see the shed (closed) here.

>use stool
Dropped.

Now you might want to get on the stool.

* * *

>use stool
You get onto the stool.

>get bucket
Taken.

>w
(first getting off the stool)

Outskirts of Town
There's less town here than there is to the South. The garden is east. The space center is North. The road is West.

>e
The Garden
A small garden. There are a few different kinds of flowers and a few different kinds of squash. It's a peaceful place. A spigot on the wall sits above a circular indent in the dirt.

You can see a stool and the shed (closed) here.

>e
Bedroom
It's your bedroom. It's not very interesting. The hall is to the east. The side door (open) leads out of the house to the West. 

On the nightstand is an iPod.

* * *

>d
Basement
The dark basement of your house. The hall is upstairs. The Tunnel of Extraction is to the west.

You can see The Tunnel of Extraction, a vat (closed) and a key cabinet (in which is a small metal key) here.

>open vat
You lift the large plastic lid off of the vat, revealing the pungent rocket fuel beneath.

* * *

>fill bucket
What do you want to fill the bucket in?

>fill bucket in vat
You dip the bucket in the vat of rocket fuel and come out with a fair amount. This stuff is lighter than it looks!

>will bucket with fuel
That's not a verb I recognise.

>fill bucket with fuel
Try DIPping the bucket in something.

>w
You go through the long and winding Tunnel of Extraction.

Abandoned Warehouse
The warehouse is old and abandoned. It is big and extends south. Not much more to say. The Road is to the North. The Tunnel of Extraction is below. There are holes in the wall to the East and West.

You can see The Tunnel of Extraction here.

>n
Road
It's a road, like what people travel on. The outskirts of town are to the east. To the North you can see a fork in the road. The stream is west.

>n
Further Along the Road
More road! There's a fork in the road here. The main road goes North and South. To the West there's a parking lot.

>e
You can't go that way.

>s
Road
It's a road, like what people travel on. The outskirts of town are to the east. To the North you can see a fork in the road. The stream is west.

>e
Outskirts of Town
There's less town here than there is to the South. The garden is east. The space center is North. The road is West.

* * *

>n
Launch Pad
The place where rockets take off from. The rest of the Space Center is South.

You can see a spaceship here.

>x ship
A very small rocket. Just big enough to carry one person to space.

>open ship
You open the spaceship, revealing an ON button, a LAUNCH button, a spacesuit and a helmet.

>get in ship
You get into the spaceship.

In the spaceship you can see an ON button, a LAUNCH button, a spacesuit and a helmet.

>put fuel in ship
You pour the rocket fuel into the ship's fuel hatch, closing the hatch when you are done.

* * *

>restart
Unsafe
An Interactive Fiction by Brian Chen and Jakob Weisblat
Release 6 / Serial number 190228 / Inform 7 build 6M62 (I6/v6.33 lib 6/12N) SD

Bedroom
It's your bedroom. It's not very interesting. The hall is to the east. The side door (closed) leads out of the house to the West. 

You've just gotten out of your bed, having woken up from a nap.

On the nightstand is an iPod.

>open door
You open the Side Door.

>w
The Garden
A small garden. There are a few different kinds of flowers and a few different kinds of squash. It's a peaceful place. A spigot on the wall sits above a circular indent in the dirt. You could swear there used to be a bucket somewhere around here, but you don't see it anywhere...

You can see the shed (closed) here.

>get bucket
You can't reach the roof of the shed.

>undo
The Garden
[Previous turn undone.]

>restart
Are you sure you want to restart?

>y
Unsafe
An Interactive Fiction by Brian Chen and Jakob Weisblat
Release 6 / Serial number 190228 / Inform 7 build 6M62 (I6/v6.33 lib 6/12N) SD

Bedroom
It's your bedroom. It's not very interesting. The hall is to the east. The side door (closed) leads out of the house to the West. 

You've just gotten out of your bed, having woken up from a nap.

On the nightstand is an iPod.

>e
Hall
The hall in the middle of your house. Your bedroom is to the West. The staircase leading upwards is to the North. The back entryway is to the South. The kitchen is to the East. There is a muddy brown key hanging from a hook on the wall. You can also go down to the basement from here.

You can see a Staircase and a muddy brown key here.

* * *

>e
Kitchen
Where food happens. The hall is to the west.

You can see a toaster, a cabinet (closed), a refrigerator (closed) and a stool here.

>get stool
Taken.

* * *

>w
The Garden
A small garden. There are a few different kinds of flowers and a few different kinds of squash. It's a peaceful place. A spigot on the wall sits above a circular indent in the dirt. You could swear there used to be a bucket somewhere around here, but you don't see it anywhere...

You can see the shed (closed) here.

>put stool
What do you want to put the stool in?

>undo
The Garden
[Previous turn undone.]

>put down stool
Dropped.

* * *

>get on stool
You get onto the stool.

>get bucket
Taken.

* * *

>w
(first getting off the stool)

Outskirts of Town
There's less town here than there is to the South. The garden is east. The space center is North. The road is West.

>w
Road
It's a road, like what people travel on. The outskirts of town are to the east. To the North you can see a fork in the road. The stream is west. The warehouse is south.

* * *

>w
By the Stream
There's a stream, making whatever sound water makes. There's also a scary warning sign. The road is to the east, and the clearing is to the south.

>take water
You dip the bucket in the water, coming out with a bucketful of water and a few... piranhas?!

>e
Road
It's a road, like what people travel on. The outskirts of town are to the east. To the North you can see a fork in the road. The stream is west. The warehouse is south.

>e
Outskirts of Town
There's less town here than there is to the South. The garden is east. The space center is North. The road is West.

>e
The Garden
A small garden. There are a few different kinds of flowers and a few different kinds of squash. It's a peaceful place. A spigot on the wall sits above a circular indent in the dirt.

You can see a stool and the shed (closed) here.

* * *

>e
Hall
The hall in the middle of your house. Your bedroom is to the West. The staircase leading upwards is to the North. The back entryway is to the South. The kitchen is to the East. There is a muddy brown key hanging from a hook on the wall. You can also go down to the basement from here.

You can see a Staircase and a muddy brown key here.

>u
Upstairs Hall
The second floor of your house. Stairs lead down. The study is west, and the bathroom is east.

You can see a Staircase and a left running shoe here.

>e
Bathroom
It's just a bathroom.

You can see a mirror, a medicine cabinet (closed) and a bathtub (empty) here.

* * *

>get in tub
You are a person of few principles, but one of those principles is never to enter a bathtub while wearing anything. (You're wearing pants, underwear, socks, a shirt, work shoes, a belt, a hat and a jacket.)

>take off pants
You need to take your shoes off first!

* * *

>take off shoes
You take off work shoes.

>take off socks
You take off socks.

>take off pants
You need to take your belt off first!

>get in tub
You are a person of few principles, but one of those principles is never to enter a bathtub while wearing anything. (You're wearing pants, underwear, a shirt, a belt, a hat and a jacket.)

>take off underwear
You need to take your pants off first!

>take off belt
You take off the belt.

* * *

>take off pants
You take off pants.

>take off underwear
You take off underwear.

>take off hat
You take off the hat.

>take off jacket
You take off the jacket.

>take off shirt
You take off the shirt.

>get in tub
You can't enter that tub, it's not even half full!

>undo
Bathroom
[Previous turn undone.]

>restart
Are you sure you want to restart?

* * *

>undo
Abandoned Train Station
[Previous turn undone.]

>get on platform
You get onto the edge of the platform.

A train enters the station while you're jamming to the music, and you trip and fall into the train tracks in front of it. That was really dumb.

You've reached one of this game's 14 endings! In that game you used 37 moves. The optimal number of moves is 37.
Great job, you got the optimal number of moves!

    *** You have died ***

Would you like to RESTART, RESTORE a saved game, QUIT or UNDO the last command?

* * *

>restart
Unsafe
An Interactive Fiction by Brian Chen and Jakob Weisblat
Release 6 / Serial number 190228 / Inform 7 build 6M62 (I6/v6.33 lib 6/12N) SD

Bedroom
It's your bedroom. It's not very interesting. The hall is to the East. The side door (closed) leads out of the house to the West. 

You've just gotten out of your bed, having woken up from a nap.

On the nightstand is an iPod.

* * *

>undo
A Spooky Lair
[Previous turn undone.]

>touch candle
You touch the candle. The flame leaps onto your hair. Boom!

You've reached one of this game's 14 endings! In that game you used 17 moves. The optimal number of moves is 17.
Great job, you got the optimal number of moves!

    *** You have died ***

Would you like to RESTART, RESTORE a saved game, QUIT or UNDO the last command?

>restart
Unsafe
An Interactive Fiction by Brian Chen and Jakob Weisblat
Release 6 / Serial number 190228 / Inform 7 build 6M62 (I6/v6.33 lib 6/12N) SD

Bedroom
It's your bedroom. It's not very interesting. The hall is to the East. The side door (closed) leads out of the house to the West. 

You've just gotten out of your bed, having woken up from a nap.

On the nightstand is an iPod.

>open door
You open the Side Door.

* * *

>w
The Garden
A small garden. There are a few different kinds of flowers and a few different kinds of squash. It's a peaceful place. A spigot on the wall sits above a circular indent in the dirt. You could swear there used to be a bucket somewhere around here, but you don't see it anywhere...

The side door to your house is East, and a path leads off towards town to the West.

You can see the shed (closed) here.

>x me
You're wearing pants, underwear, socks, a shirt, work shoes, a belt, a hat and a jacket.

* * *

>restart
Unsafe
An Interactive Fiction by Brian Chen and Jakob Weisblat
Release 5 / Serial number 190228 / Inform 7 build 6M62 (I6/v6.33 lib 6/12N) SD

Bedroom
It's your bedroom. It's not very interesting. The hall is to the east. The side door (closed) leads out of the house to the West. 

You've just gotten out of your bed, having woken up from a nap.

On the nightstand is an iPod.

>test wasps
>--> The following tests are available:
'test all'
'test platform'
'test toaster'
'test fly'
'test space'
'test car'
'test running'
'test candle'
'test cage'
'test piranhas'
'test trees'
'test treetops'
'test moose'
'test time-machine'
'test bear'
'test glue'
'test pie'

* * *

>restart
Unsafe
An Interactive Fiction by Brian Chen and Jakob Weisblat
Release 5 / Serial number 190228 / Inform 7 build 6M62 (I6/v6.33 lib 6/12N) SD

Bedroom
It's your bedroom. It's not very interesting. The hall is to the east. The side door (closed) leads out of the house to the West. 

You've just gotten out of your bed, having woken up from a nap.

On the nightstand is an iPod.

>e
Hall
The hall in the middle of your house. Your bedroom is to the West. The staircase leading upwards is to the North. The back entryway is to the South. The kitchen is to the East. There is a muddy brown key hanging from a hook on the wall. You can also go down to the basement from here.

You can see a Staircase and a muddy brown key here.

* * *

>w
Study
Where you study. The hall is east.

On the desk are a dime and a quarter.

You can also see the closet door here.

>go closet
The Closet
A small room. The study is south.

You can see the closet door and a chest of drawers here.

>x drawers
You can't use multiple objects with that verb.

>x chest of drawers
It's an old wooden chest with 5 drawers. The bottom drawer is open.

>open drawer
Which do you mean, the first drawer, the second drawer, the third drawer, the fourth drawer or the fifth drawer?

* * *

>undo
Woods
[Previous turn undone.]

>undo
Woods
[Previous turn undone.]

>[34] throw nest
You toss the wasps' nest. Your last sensation is a barrage of stings from the army of angry wasps that bursts from the nest to attack you.

You've reached one of this game's 14 endings! In that game you used 33 moves. The optimal number of moves is 34.
Uh-oh, the puzzle is broken! Send us an email!

    *** You have died ***

Would you like to RESTART, RESTORE a saved game, QUIT or UNDO the last command?

>undo
Woods
[Previous turn undone.]

>undo
Top of Pine Tree
[Previous turn undone.]

>[33] take nest
You can't see any such thing.

>[34] throw nest
You can't see any such thing.

>l
Top of Pine Tree
The pine tree is short. You're on top.

>x nest
You can't see any such thing.

>x wasp nest
You can't see any such thing.

>x woods
You can't see any such thing.

>d
Woods
There's lots of trees, in particular, an ash tree, an elm tree, and a pine tree. The edge of the woods is to the east. Going south, you can see signs for a hunting lodge.

You can see a wasps' nest and a grizzly bear here.

>x nest
A light brown nest of wasps in the tree's branches.

>unod
That's not a verb I recognise.

>undo
Woods
[Previous turn undone.]

>undo
Woods
[Previous turn undone.]

>undo
Top of Pine Tree
[Previous turn undone.]

>undo
Top of Pine Tree
[Previous turn undone.]

>x nest
You can't see any such thing.

>l
Top of Pine Tree
The pine tree is short. You're on top.

>undo
Top of Pine Tree
[Previous turn undone.]

>undo
"Undo" capacity exhausted. Sorry!

>undo
"Undo" capacity exhausted. Sorry!

>restart
Are you sure you want to restart?

>u
Please answer yes or no.

>y
Unsafe
An Interactive Fiction by Brian Chen and Jakob Weisblat
Release 2 / Serial number 190225 / Inform 7 build 6M62 (I6/v6.33 lib 6/12N) SD

Bedroom
It's your bedroom. It's not very interesting. The hall is to the east. The side door (closed) leads out of the house to the West. 

You're lying in your bed, just having woken up from a nap.

On the nightstand is an iPod.

* * *

>undo
Woods
[Previous turn undone.]

>undo undo
That's not a verb I recognise.

>undo
Woods
[Previous turn undone.]

* * *

>undo
Top of Pine Tree
[Previous turn undone.]

>[33] take nest
You can't see any such thing.

>[34] throw nest
You can't see any such thing.

>undo
Top of Pine Tree
[Previous turn undone.]

>undo
Top of Pine Tree
[Previous turn undone.]

>[34] throw nest
You can't see any such thing.

>undo
Top of Pine Tree
[Previous turn undone.]

>undo
Top of Pine Tree
[Previous turn undone.]

>[32] d

Woods
There's lots of trees, in particular, an ash tree, an elm tree, and a pine tree. The edge of the woods is to the east. Going south, you can see signs for a hunting lodge.

You can see a grizzly bear here.

>[33] take nest
You can't see any such thing.

>[34] throw nest
You can't see any such thing.

>undo
Woods
[Previous turn undone.]

>undo
Woods
[Previous turn undone.]

>[34] throw nest
You can't see any such thing.

>undo
Woods
[Previous turn undone.]

>undo
Top of Pine Tree
[Previous turn undone.]

>[33] take nest
Try as you might, you can't reach the nest. But you think you could shake the tree to make it drop.

>[34] throw nest
You toss the wasps' nest. Your last sensation is a barrage of stings from the army of angry wasps that bursts from the nest to attack you.

You've reached one of this game's 14 endings! In that game you used 32 moves. The optimal number of moves is 34.
Uh-oh, the puzzle is broken! Send us an email!

    *** You have died ***

Would you like to RESTART, RESTORE a saved game, QUIT or UNDO the last command?

* * *

>x nest
A light brown nest of wasps in the tree's branches.

>get nest
Try as you might, you can't reach the nest. But you think you could shake the tree to make it drop.

>throw nest
You can only throw something you already have.

>shake tree
You shake the tree vigorously.
The wasps' nest is dislodged. You watch it fall to the top of the elm tree.

>undo
Top of Ash Tree
[Previous turn undone.]

>shake branch
You shake the tree vigorously.
The wasps' nest is dislodged. You watch it fall to the top of the elm tree.

>d
Upper Branches of Ash Tree
Even more tree.

>d
Middle Branches of Ash Tree
More tree.

>d
Lower Branches of Ash Tree
You're a bit off the ground in the ash tree.

>d
Woods
There's lots of trees, in particular, an ash tree, an elm tree, and a pine tree. The edge of the woods is to the east. Going south, you can see signs for a hunting lodge. You can hear a faint sound from above.

You can see a grizzly bear here.

>climb elm
Middle Branches of Elm Tree
You're roughly half of the height of the Elm Tree.

>u
Top of Elm Tree
You can see a wasps' nest here.

>shake
What do you want to shake?

>shake tree
You shake the tree vigorously.
The wasps' nest is dislodged. You watch it fall to the top of the pine tree.

>d
Middle Branches of Elm Tree
You're roughly half of the height of the Elm Tree.

>d
Woods
There's lots of trees, in particular, an ash tree, an elm tree, and a pine tree. The edge of the woods is to the east. Going south, you can see signs for a hunting lodge. You can hear a faint sound from above.

You can see a grizzly bear here.

>climb pine
Top of Pine Tree
The pine tree is short. You're on top.

You can see a wasps' nest here.

>shake tree
You shake the tree vigorously.
The wasps' nest is dislodged. You watch it fall to the forest floor.

>d
Woods
There's lots of trees, in particular, an ash tree, an elm tree, and a pine tree. The edge of the woods is to the east. Going south, you can see signs for a hunting lodge.

You can see a wasps' nest and a grizzly bear here.

>x nest
A light brown nest of wasps.

* * *

Welcome to Unsafe. If you're not sure what to do, type "help".

Bedroom
It's your bedroom. It's not very interesting. The hall is to the East. The side door (closed) leads out of the house to the West. 

You've just gotten out of your bed, having woken up from a nap.

On the nightstand is an iPod.

>w
You can't go through the Side Door because it's closed.

* * *

>w
Outskirts of Town
There's less town here than there is to the South. The garden is East. The space center is North. The road is West.

>w
Road
It's a road, like what people travel on. The outskirts of town are to the East. To the North you can see a fork in the road. The stream is West. The warehouse is South.

>n
Further Along the Road
More road! There's a fork in the road here. The main road goes North and South. To the West there's a parking lot.

* * *

>n
Abandoned Train Station
No trains.

The road leads South back toward town.

You can see a map here.

>s
Further Along the Road
More road! There's a fork in the road here. The main road goes North and South. To the West there's a parking lot.

I beg your pardon?

>e
You can't go that way.

>s
Road
It's a road, like what people travel on. The outskirts of town are to the East. To the North you can see a fork in the road. The stream is West. The warehouse is South.

>s
Abandoned Warehouse
The warehouse is old and abandoned. It is big and extends South. Not much more to say. The Road is to the North. The Tunnel of Extraction is below. There are holes in the wall to the East and West.

You can see The Tunnel of Extraction here.

>e
Town Square
The Town Square stretches out in front of you. There are 10 or 20 unremarkable buildings that you couldn't care less about. South of you is the Mad Scientist's House. West, a hole in the wall leads into the Abandoned Warehouse. North of here, the town thins out.

You can see the Mad Scientist's Grand Entrance here.

* * *

>e
You can't go that way.

>restart
Are you sure you want to restart?

>t
Please answer yes or no.

>y
Welcome to Unsafe. If you're not sure what to do, type "help".

Bedroom
It's your bedroom. It's not very interesting. The hall is to the East. The side door (closed) leads out of the house to the West. 

You've just gotten out of your bed, having woken up from a nap.

On the nightstand is an iPod.

>e
Hall
The hall in the middle of your house. Your bedroom is to the West. The staircase leading upwards is to the North. The back entryway is to the South. The kitchen is to the East. You can also go down to the basement from here.

There is a muddy brown key hanging from a hook on the wall.

* * *

>n
You drive across the tracks into the train station turnaround. This is the end of the road.

Abandoned Train Station (in the blue car)
No trains.

The road leads South back toward town.

You can see a map here.

>e
You can't drive indoors, that would be a safety hazard.

>l
Abandoned Train Station (in the blue car)
No trains.

The road leads South back toward town.

You can see a map here.

>n
You can't go that way.

>s
Further Along the Road (in the blue car)
More road! There's a fork in the road here. The main road goes North and South. To the West there's a parking lot.

* * *

>s
Road (in the blue car)
It's a road, like what people travel on. The outskirts of town are to the East. To the North you can see a fork in the road. The stream is West. The warehouse is South.

>s
You can't drive indoors, that would be a safety hazard.

>w
By the Stream (in the blue car)
There's a stream, making whatever sound water makes. There's also a scary warning sign. The road is to the East, and the clearing is to the South.

>s
Clearing (in the blue car)
It's very clear here. The edge of the woods is to the West. A hole that leads into the abandoned warehouse is to the East. There's a stream to the North.

>w
Edge of the Woods (in the blue car)
The woods start here and extend to the West. There's a clearing to the East.

>w
As you walk into the woods, a large grizzly bear shows up, baring (bear-ing?) its teeth at you. You hastily take three steps back.
The bear seems to be guarding the entrance to the woods. Seems like it would be awfully difficult to get through here unless the bear were somehow distracted. With food, maybe?

* * *

>w
You're too scared of the bear to go there. You might be able to distract the bear with something it likes eating, though.

>e
Clearing (in the blue car)
It's very clear here. The edge of the woods is to the West. A hole that leads into the abandoned warehouse is to the East. There's a stream to the North.

>s
You can't go that way.

>e
You can't drive indoors, that would be a safety hazard.

>n
By the Stream (in the blue car)
There's a stream, making whatever sound water makes. There's also a scary warning sign. The road is to the East, and the clearing is to the South.

>e
Road (in the blue car)
It's a road, like what people travel on. The outskirts of town are to the East. To the North you can see a fork in the road. The stream is West. The warehouse is South.

>w
By the Stream (in the blue car)
There's a stream, making whatever sound water makes. There's also a scary warning sign. The road is to the East, and the clearing is to the South.

>w
You can't go that way.

>s
Clearing (in the blue car)
It's very clear here. The edge of the woods is to the West. A hole that leads into the abandoned warehouse is to the East. There's a stream to the North.

* * *

>w
Edge of the Woods (in the blue car)
The woods start here and extend to the West. There's a clearing to the East.

>n
You can't go that way.

>e
Clearing (in the blue car)
It's very clear here. The edge of the woods is to the West. A hole that leads into the abandoned warehouse is to the East. There's a stream to the North.

>e
You can't drive indoors, that would be a safety hazard.

>e
You can't drive indoors, that would be a safety hazard.

>open car
You open the blue car.

>out
You get out of the blue car.

Clearing
It's very clear here. The edge of the woods is to the West. A hole that leads into the abandoned warehouse is to the East. There's a stream to the North.

You can see a blue car (empty) here.

>e
Abandoned Warehouse
The warehouse is old and abandoned. It is big and extends South. Not much more to say. The Road is to the North. The Tunnel of Extraction is below. There are holes in the wall to the East and West.

You can see The Tunnel of Extraction here.

>e
Town Square
The Town Square stretches out in front of you. There are 10 or 20 unremarkable buildings that you couldn't care less about. South of you is the Mad Scientist's House. West, a hole in the wall leads into the Abandoned Warehouse. North of here, the town thins out.

You can see the Mad Scientist's Grand Entrance here.

>w
Abandoned Warehouse
The warehouse is old and abandoned. It is big and extends South. Not much more to say. The Road is to the North. The Tunnel of Extraction is below. There are holes in the wall to the East and West.

You can see The Tunnel of Extraction here.

>s
A Spooky Lair
A lair in which a demonic ritual might be held. There is a table with a pentagram drawn on it. It's the South end of the warehouse; the only exit is North, to the rest of the warehouse.

On the table are a candle and a sacrificial knife.

You can also see a snake and an ancient cabinet (closed) here.

>e
You can't go that way.

>u
You can't go that way.

>n
Abandoned Warehouse
The warehouse is old and abandoned. It is big and extends South. Not much more to say. The Road is to the North. The Tunnel of Extraction is below. There are holes in the wall to the East and West.

You can see The Tunnel of Extraction here.

>d
This tunnel was pretty spooky the first time you went through it. You take a second to mentally prepare yourself before going through again.

>d
You go through the long and winding Tunnel of Extraction.

Basement
The dark basement of your house. The hall is upstairs. The Tunnel of Extraction is to the West.

You can see The Tunnel of Extraction, a vat (closed) and a key cabinet (in which is a small metal key) here.

>w
You go through the long and winding Tunnel of Extraction.

Abandoned Warehouse
The warehouse is old and abandoned. It is big and extends South. Not much more to say. The Road is to the North. The Tunnel of Extraction is below. There are holes in the wall to the East and West.

You can see The Tunnel of Extraction here.

>d
You go through the long and winding Tunnel of Extraction.

Basement
The dark basement of your house. The hall is upstairs. The Tunnel of Extraction is to the West.

You can see The Tunnel of Extraction, a vat (closed) and a key cabinet (in which is a small metal key) here.

>u
Hall
The hall in the middle of your house. Your bedroom is to the West. The staircase leading upwards is to the North. The back entryway is to the South. The kitchen is to the East. You can also go down to the basement from here.

There is a muddy brown key hanging from a hook on the wall.

>take key
(the Toyota key)
You already have that.

>i
You are carrying:
  a Toyota key
  pants (being worn)
  underwear (being worn)
  socks (being worn)
  a shirt (being worn)
  work shoes (being worn)
  a belt (being worn)
  a hat (being worn)
  a jacket (being worn)

>take brown key
Taken.

>u
Upstairs Hall
The second floor of your house. Stairs lead down. The study is West, and the bathroom is East.

You can see a left running shoe here.

* * *

>e
Upstairs Hall
The second floor of your house. Stairs lead down. The study is West, and the bathroom is East.

You can see a left running shoe here.

>s
You can't go that way.

>d
Hall
The hall in the middle of your house. Your bedroom is to the West. The staircase leading upwards is to the North. The back entryway is to the South. The kitchen is to the East. You can also go down to the basement from here.

>e
Kitchen
Where food happens. The hall is to the West.

You can see a toaster, a cabinet (closed), a refrigerator (closed) and a stool here.

* * *

>open cabinet
You open the cabinet, revealing a top drawer, a middle drawer and a bottom drawer.

>open
What do you want to open?

>open all
You can't use multiple objects with that verb.

>e
You can't go that way.

>open fridge
You open the refrigerator, revealing a fish and a pie.

>take all
fish: One thing at a time!

One thing at a time!
pie: One thing at a time!

One thing at a time!

>take fish
Taken.

* * *

>take pie
Taken.

>w
Hall
The hall in the middle of your house. Your bedroom is to the West. The staircase leading upwards is to the North. The back entryway is to the South. The kitchen is to the East. You can also go down to the basement from here.

* * *

>w
Road
It's a road, like what people travel on. The outskirts of town are to the East. To the North you can see a fork in the road. The stream is West. The warehouse is South.

>s
Abandoned Warehouse
The warehouse is old and abandoned. It is big and extends South. Not much more to say. The Road is to the North. The Tunnel of Extraction is below. There are holes in the wall to the East and West.

You can see The Tunnel of Extraction here.

>w
Clearing
It's very clear here. The edge of the woods is to the West. A hole that leads into the abandoned warehouse is to the East. There's a stream to the North.

You can see a blue car (empty) here.

I beg your pardon?

>w
Edge of the Woods
The woods start here and extend to the West. There's a clearing to the East.

>w
You're too scared of the bear to go there. You might be able to distract the bear with something it likes eating, though.

>throw fish
You throw the fish to the West. The bear looks at the fish curiously.

>w
You're too scared of the bear to go there. You might be able to distract the bear with something it likes eating, though.

The bear finally decides to eat the fish, in a big gulp.

>w
You're too scared of the bear to go there. You might be able to distract the bear with something it likes eating, though.

The bear rubs its belly sleepily. Maybe it'll fall asleep soon.

>w
You're too scared of the bear to go there. You might be able to distract the bear with something it likes eating, though.

The bear flops onto its full stomach and starts snoring.

>w
Woods
There's lots of trees, in particular, an ash tree, an elm tree, and a pine tree. The edge of the woods is to the East. Going South, you can see signs for a hunting lodge. You can hear a faint sound from above.

You can see a grizzly bear here.

>x bear
You see nothing special about the grizzly bear.

>hit bear
With your bear (*ahem*) bare hands? You're kind of dumb, but not *that* dumb.

>e
Edge of the Woods
The woods start here and extend to the West. There's a clearing to the East.

>e
Clearing
It's very clear here. The edge of the woods is to the West. A hole that leads into the abandoned warehouse is to the East. There's a stream to the North.

You can see a blue car (empty) here.

>in car
I only understood you as far as wanting to (go) in inside.

>enter car
You get into and start the car. It's ready to roll!

>close car
You close the blue car.

>w
Edge of the Woods (in the blue car)
The woods start here and extend to the West. There's a clearing to the East.

>w
Woods (in the blue car)
There's lots of trees, in particular, an ash tree, an elm tree, and a pine tree. The edge of the woods is to the East. Going South, you can see signs for a hunting lodge. You can hear a faint sound from above.

You can see a grizzly bear here.

>w
Too many trees. You'd get lost.

>u
Too many trees. You'd get lost.

>out
You can't get out of the closed blue car.

>open car
You open the blue car.

>out
You get out of the blue car.

Woods
There's lots of trees, in particular, an ash tree, an elm tree, and a pine tree. The edge of the woods is to the East. Going South, you can see signs for a hunting lodge. You can hear a faint sound from above.

You can see a blue car (empty) and a grizzly bear here.

>u
Too many trees. You'd get lost.

>u
Too many trees. You'd get lost.

* * *

>n
Launch Pad
The place where rockets take off from. The rest of the Space Center is South.

You can see a spaceship here.

>open spaceship
You open the spaceship, revealing an ON button, a LAUNCH button, a spacesuit and a helmet.

>push on
You can't do that without being in the ship.

>in
You can't go that way.

>enter ship
You get into the spaceship.

In the spaceship you can see an ON button, a LAUNCH button, a spacesuit and a helmet.

* * *

>push on
You press the ON button. All around you dials spin and lights blink.

A dialog appears on the screen: WARNING: LOW FUEL. SAY "confirm" to continue. Mission abort HIGHLY recommended.

>confirm
That's not a verb I recognise.

>say confirm
(to the computer)
The dialog on the screen goes away. The screen now reads READY FOR LAUNCH.

>push launch
Launching with the door open seems like an extraordinarily bad idea, even for yourself.

* * *

>close door
You close the spaceship.

>push launch
The computer counts down: "3... 2... 1... LAUNCHING". 

 The world around you starts to disappear into the smoke emmitted from the rocket engine. You feel yourself pressed into the seat as the spaceship lifts off toward the sky. 

The computer says "This ship is equipped with an auto spacesuit. Simply say SUIT UP and the ship will automatically put your space suit on you so you can go out into space."

>suit up
That's not a verb I recognise.

>say suit up
(to the computer)
The spaceship's machinery puts a space suit on you faster than you could possibly have done it yourself.

The computer announces: "Auto pilot has engaged. Say CANCEL to fly the ship yourself. Auto pilot has detected that the fuel level is low and will land the ship momentarily."

>say cancel
(to the computer)
The autopilot is disabled.

>l
The spaceship
In the spaceship you can see an ON button and a LAUNCH button.

The VERY LOW FUEL light blinks on in the corner of the dashboard.

>push launch
You've already launched, what do you expect to happen?

With a putter then a WHOOSH, the ship runs out of fuel. You don't have much choice but to grip the controls and try to fly it like a plane.

>z
Time passes.

AAAAAAAAAAAAAAAAAAAAAAAAAAAAAAAAAAAAAAAAAAAAAAAAAAAAAAAAAAAAAAAAAAAAAAAAAAAAAAAA!
The ship barrels toward the ground at an alarming rate.

>z
Time passes.

AAAAAAAAAAAAAAAAAAAAAAAAAAAAAAAAAAAAAAAAAAAAAAAAAAAAAAAAAAAAAAAAAAAAAAAAAAAAAAAA!
The ship barrels toward the ground at an alarming rate.

>z
Time passes.

AAAAAAAAAAAAAAAAAAAAAAAAAAAAAAAAAAAAAAAAAAAAAAAAAAAAAAAAAAAAAAAAAAAAAAAAAAAAAAAA!
The ship barrels toward the ground at an alarming rate.

Ruins of the Tunnel of Extraction
With a CRASH and a BOOM the ship crash lands into the ground. It breaks through the ground and as you die on impact you vaguely recognize your surroundings: this was formerly part of the Tunnel of Extraction.

You've reached one of this game's 14 endings! In that game you used 24 moves. The optimal number of moves is 21.
You can reach this ending more quickly!

    *** You have died ***

Would you like to RESTART, RESTORE a saved game, QUIT or UNDO the last command?

>z
Please give one of the answers above.

Would you like to RESTART, RESTORE a saved game, QUIT or UNDO the last command?

>restart
Welcome to Unsafe. If you're not sure what to do, type "help".

Bedroom
It's your bedroom. It's not very interesting. The hall is to the East. The side door (closed) leads out of the house to the West. 

You've just gotten out of your bed, having woken up from a nap.

On the nightstand is an iPod.

>w
You can't go through the Side Door because it's closed.

* * *

>n
Launch Pad
The place where rockets take off from. The rest of the Space Center is South.

You can see a spaceship here.

>enter spaceship
You can't get into the closed spaceship.

>undo
Launch Pad
[Previous turn undone.]

>open ship
You open the spaceship, revealing an ON button, a LAUNCH button, a spacesuit and a helmet.

>enter
You get into the spaceship.

In the spaceship you can see an ON button, a LAUNCH button, a spacesuit and a helmet.

>close ship
You close the spaceship.

>undo
Launch Pad
[Previous turn undone.]

>close ship
You close the spaceship.

>push launch
The button doesn't do anything. Maybe try turning on the spaceship first?

>undo
The spaceship
[Previous turn undone.]

>push on
You press the ON button. All around you dials spin and lights blink.

A dialog appears on the screen: WARNING: LOW FUEL. SAY "confirm" to continue. Mission abort HIGHLY recommended.

>say confirm
(to the computer)
The dialog on the screen goes away. The screen now reads READY FOR LAUNCH.

>push launch
The computer counts down: "3... 2... 1... LAUNCHING". 

 The world around you starts to disappear into the smoke emmitted from the rocket engine. You feel yourself pressed into the seat as the spaceship lifts off toward the sky. 

The computer says "This ship is equipped with an auto spacesuit. Simply say SUIT UP and the ship will automatically put your space suit on you so you can go out into space."

>l
The spaceship
In the spaceship you can see an ON button, a LAUNCH button, a spacesuit and a helmet.

The computer announces: "Auto pilot has engaged. Say CANCEL to fly the ship yourself. Auto pilot has detected that the fuel level is low and will land the ship momentarily."

>say cancel
(to the computer)
The autopilot is disabled.

>z
Time passes.

The VERY LOW FUEL light blinks on in the corner of the dashboard.

>z
Time passes.

With a putter then a WHOOSH, the ship runs out of fuel. You don't have much choice but to grip the controls and try to fly it like a plane.

>z
Time passes.

AAAAAAAAAAAAAAAAAAAAAAAAAAAAAAAAAAAAAAAAAAAAAAAAAAAAAAAAAAAAAAAAAAAAAAAAAAAAAAAA!
The ship barrels toward the ground at an alarming rate.

>z
Time passes.

AAAAAAAAAAAAAAAAAAAAAAAAAAAAAAAAAAAAAAAAAAAAAAAAAAAAAAAAAAAAAAAAAAAAAAAAAAAAAAAA!
The ship barrels toward the ground at an alarming rate.

Ruins of the Tunnel of Extraction
With a CRASH and a BOOM the ship crash lands into the ground. It breaks through the ground and as you die on impact you vaguely recognize your surroundings: this was formerly part of the Tunnel of Extraction.

You've reached one of this game's 14 endings! In that game you used 21 moves. The optimal number of moves is 21.
Great job, you got the optimal number of moves!

    *** You have died ***

Would you like to RESTART, RESTORE a saved game, QUIT or UNDO the last command?

* * *

Welcome to Unsafe. If you're not sure what to do, type "help".

Bedroom
It's your bedroom. It's not very interesting. The hall is to the East. The side door (closed) leads out of the house to the West. 

You've just gotten out of your bed, having woken up from a nap.

On the nightstand is an iPod.

>wear ipod
You have to pick up the iPod first.

* * *

Welcome to Unsafe. If you're not sure what to do, type "help".

Bedroom
It's your bedroom. It's not very interesting. The hall is to the East. The side door (closed) leads out of the house to the West. 

You've just gotten out of your bed, having woken up from a nap.

On the nightstand is an iPod.

>x iPod
It's an iPod touch, third-generation, maybe?

>x bed
It's just your bed.

>get in bed
You don't feel sleepy.

>x nightstand
On the nightstand is an iPod.

>e
Hall
The hall in the middle of your house. Your bedroom is to the West. The staircase leading upwards is to the North. The back entryway is to the South. The kitchen is to the East. There is a muddy brown key hanging from a hook on the wall. You can also go down to the basement from here.

You can see a Staircase and a muddy brown key here.

>x key
It's a key, so it presumably unlocks something. It's brown.

>x staircase
Stairs that lead between the halls on the first and second floor of your home.

>n
Upstairs Hall
The second floor of your house. Stairs lead down. The study is west, and the bathroom is east.

You can see a Staircase and a left running shoe here.

>x shoe
The shoe goes on your left foot. You only run if you're wearing this shoe and its partner.

>e
Bathroom
It's just a bathroom.

You can see a mirror, a medicine cabinet (closed) and a bathtub (empty) here.

>x mirror
You can see your own reflection in the mirror. You look the same as always.

>x cabinet
A cabinet that could hold medicine and other bathroom-related stuff. It's far enough off the ground that you can't reach it unless you're standing on something, which is annoying.

>open medicine cabinet
You're not tall enough to reach the medicine cabinet. Drat!

>l
Bathroom
It's just a bathroom.

You can see a mirror, a medicine cabinet (closed) and a bathtub (empty) here.

>x bathtub
It's a bathtub. Big enough to sit in comfortably or lie down in uncomfortably. 

The drain is unplugged. The faucet is off. The tub has no water in it.

>w
Upstairs Hall
The second floor of your house. Stairs lead down. The study is west, and the bathroom is east.

You can see a Staircase and a left running shoe here.

>w
Study
Where you study. The hall is east.

On the desk are a dime and a quarter.

You can also see the closet door here.

>x dime
Just a regular old dime. Minted 1994.

>x quarter
Arkansas state quarter. Minted 2003. Looks pretty new for a 2003 quarter.

>x door
You look into the closet. Looks like a closet.

>open closet
That's already open.

>l in closet
You find nothing of interest.

>open closet
That's already open.

>l
Study
Where you study. The hall is east.

On the desk are a dime and a quarter.

You can also see the closet door here.

>e
Upstairs Hall
The second floor of your house. Stairs lead down. The study is west, and the bathroom is east.

You can see a Staircase and a left running shoe here.

* * *

>d
Hall
The hall in the middle of your house. Your bedroom is to the West. The staircase leading upwards is to the North. The back entryway is to the South. The kitchen is to the East. There is a muddy brown key hanging from a hook on the wall. You can also go down to the basement from here.

You can see a Staircase and a muddy brown key here.

>x key
It's a key, so it presumably unlocks something. It's brown.

>take key
Taken.

>l
Hall
The hall in the middle of your house. Your bedroom is to the West. The staircase leading upwards is to the North. The back entryway is to the South. The kitchen is to the East. You can also go down to the basement from here.

You can see a Staircase here.

>d
Basement
The dark basement of your house. The hall is upstairs. The Tunnel of Extraction is to the west.

You can see The Tunnel of Extraction, a vat (closed) and a key cabinet (in which is a small metal key) here.

>x vat
A large vat holding a greenish liquid. Who knows how long it's been here?

>open vat
You lift the large plastic lid off of the vat, revealing the pungent rocket fuel beneath.

>x liqued
You can't see any such thing.

>x liquid
You can't see any such thing.

>l
Basement
The dark basement of your house. The hall is upstairs. The Tunnel of Extraction is to the west.

You can see The Tunnel of Extraction, a vat (in which is rocket fuel) and a key cabinet (in which is a small metal key) here.

>x cabinet
A small cabinet that looks like it once held keys for all the rooms in the house. Now it looks like there aren't very many keys in it at all.

In the key cabinet is a small metal key.

>take key
(the key cabinet)
(the small metal key)
Taken.

>i
You are carrying:
  a small metal key
  a muddy brown key
  pants (being worn)
  underwear (being worn)
  socks (being worn)
  a shirt (being worn)
  work shoes (being worn)
  a belt (being worn)
  a hat (being worn)
  a jacket (being worn)

>x cabinet
A small cabinet that looks like it once held keys for all the rooms in the house. Now it looks like there aren't very many keys in it at all.

>x key
Which do you mean, the key cabinet, the small metal key or the muddy brown key?

>take key
(the key cabinet)
(the small metal key)
You already have that.

>take cabinet
(the small metal key)
You already have that.

>x metal key
It's a key, so it presumably unlocks something. It's metal.

>l
Basement
The dark basement of your house. The hall is upstairs. The Tunnel of Extraction is to the west.

You can see The Tunnel of Extraction, a vat (in which is rocket fuel) and a key cabinet (empty) here.

>x vat
A large vat holding a greenish liquid. Who knows how long it's been here?

In the vat is rocket fuel.

>x cabinet
A small cabinet that looks like it once held keys for all the rooms in the house. Now it looks like there aren't very many keys in it at all.

>w
You go through the long and winding Tunnel of Extraction.

Abandoned Warehouse
The warehouse is old and abandoned. It is big and extends south. Not much more to say. The Road is to the North. The Tunnel of Extraction is below. There are holes in the wall to the East and West.

You can see The Tunnel of Extraction here.

>x tunnel
A long, winding tunnel. It used to be used to extract minerals and stuff. Now, it's probably still useful for extracting other things.

>x wall
You can't see any such thing.

>w
Clearing
It's very clear here. The edge of the woods is to the west. A hole that leads into the abandoned warehouse is to the east. There's a stream to the north.

>e
Abandoned Warehouse
The warehouse is old and abandoned. It is big and extends south. Not much more to say. The Road is to the North. The Tunnel of Extraction is below. There are holes in the wall to the East and West.

You can see The Tunnel of Extraction here.

>s
A Spooky Lair
A lair in which a demonic ritual might be held. There is a table with a pentagram drawn on it. It's the south end of the warehouse; the only exit is north, to the rest of the warehouse.

On the table are a candle and a sacrificial knife.

You can also see four snakes and an ancient cabinet (closed) here.

>take all
candle: One thing at a time!
sacrificial knife: One thing at a time!

>take snakes
You can't see any such thing.

>take snake
You can't see any such thing.

>take cabinet
That's fixed in place.

>open cabinet
You open the ancient cabinet, revealing three jars.

>take jar
Taken.

>take jar
Taken.

>l
A Spooky Lair
A lair in which a demonic ritual might be held. There is a table with a pentagram drawn on it. It's the south end of the warehouse; the only exit is north, to the rest of the warehouse.

On the table are a candle and a sacrificial knife.

You can also see four snakes and an ancient cabinet (empty) here.

>x snake
You can't see any such thing.

>x knife
A knife that looks like it might be used in a demonic ritual - or, you know, for cutting stuff.

>x candle
It's a candle. It's burning, the way candles do.

>x table
On the table are a candle and a sacrificial knife.

>l
A Spooky Lair
A lair in which a demonic ritual might be held. There is a table with a pentagram drawn on it. It's the south end of the warehouse; the only exit is north, to the rest of the warehouse.

On the table are a candle and a sacrificial knife.

You can also see four snakes and an ancient cabinet (empty) here.

>w
You can't go that way.

>e
You can't go that way.

>n
Abandoned Warehouse
The warehouse is old and abandoned. It is big and extends south. Not much more to say. The Road is to the North. The Tunnel of Extraction is below. There are holes in the wall to the East and West.

You can see The Tunnel of Extraction here.

>s
A Spooky Lair
A lair in which a demonic ritual might be held. There is a table with a pentagram drawn on it. It's the south end of the warehouse; the only exit is north, to the rest of the warehouse.

On the table are a candle and a sacrificial knife.

You can also see four snakes and an ancient cabinet (empty) here.

>l
A Spooky Lair
A lair in which a demonic ritual might be held. There is a table with a pentagram drawn on it. It's the south end of the warehouse; the only exit is north, to the rest of the warehouse.

On the table are a candle and a sacrificial knife.

You can also see four snakes and an ancient cabinet (empty) here.

>i
You are carrying:
  three jars (closed)
  a small metal key
  a muddy brown key
  pants (being worn)
  underwear (being worn)
  socks (being worn)
  a shirt (being worn)
  work shoes (being worn)
  a belt (being worn)
  a hat (being worn)
  a jacket (being worn)

>x hat
You see nothing special about the hat.

>x shoes
You see nothing special about work shoes.

>l
A Spooky Lair
A lair in which a demonic ritual might be held. There is a table with a pentagram drawn on it. It's the south end of the warehouse; the only exit is north, to the rest of the warehouse.

On the table are a candle and a sacrificial knife.

You can also see four snakes and an ancient cabinet (empty) here.

>n
Abandoned Warehouse
The warehouse is old and abandoned. It is big and extends south. Not much more to say. The Road is to the North. The Tunnel of Extraction is below. There are holes in the wall to the East and West.

You can see The Tunnel of Extraction here.

* * *

>n
Road
It's a road, like what people travel on. The outskirts of town are to the east. To the North you can see a fork in the road. The stream is west.

>w
By the Stream
There's a stream, making whatever sound water makes. There's also a scary warning sign.

>l
By the Stream
There's a stream, making whatever sound water makes. There's also a scary warning sign.

>l
By the Stream
There's a stream, making whatever sound water makes. There's also a scary warning sign.

* * *

Welcome to Unsafe. If you're not sure what to do, type "help".

Bedroom
It's your bedroom. It's not very interesting. The hall is to the East. The side door (closed) leads out of the house to the West. 

You've just gotten out of your bed, having woken up from a nap.

On the nightstand is an iPod.

>x me
You look like you could be in a cartoon. You're wearing pants, underwear, socks, a shirt, work shoes, a belt, a hat and a jacket.

>x pants
You see nothing special about pants.

>x shoes
Shoes you wear to work. They look professional, but you can't do as much physical activity in them.

>x belt
You see nothing special about the belt.

>x hat
You see nothing special about the hat.

>x jacket
You see nothing special about the jacket.

>x me
You look like you could be in a cartoon. You're wearing pants, underwear, socks, a shirt, work shoes, a belt, a hat and a jacket.